aaa	工
aab	医药卫生
aac	勤劳勇敢
aad	匿
aae	节节胜利
aaf	苷
aag	戒毒
aah	芽
aai	工党
aaj	工时
aak	戒
aal	东欧国家
aam	蘣
aan	苣
aao	工业
aap	工农
aaq	工贸
aar	芭蕾舞
aas	式样
aat	荛
aau	工资
aav	勤勤恳恳
aaw	工作
aax	警戒线
aay	式
aba	若隐若现
abb	 
abc	节能
abd	节奏
abe	荫
abf	茸
abg	蔯
abh	邛
abi	蒸
abj	节
abk	警卫员
abl	䓝
abm	茁
abn	芤
abo	节煤
abp	 
abq	蒸馏
abr	艿
abs	 
abt	蕯
abu	萨
abv	匜
abw	节俭
abx	节约
aby	芨
aca	茎
acb	芭
acc	茅台
acd	英勇奋斗
ace	蓪
acf	英勇献身
acg	节能型
ach	 
aci	茅台酒
acj	 
ack	苔
acl	䓿
acm	 
acn	茅
aco	䔍
acp	 
acq	功能键
acr	 
acs	 
act	戎马生涯
acu	英勇斗争
acv	 
acw	荾
acx	 
acy	芆
ada	葫芦
adb	苊
adc	蕻
add	基础
ade	戎
adf	苦
adg	葳
adh	荐
adi	藉
adj	若是
adk	若
adl	基因
adm	项
adn	藏
ado	基数
adp	其它
adq	基金
adr	巨大的
ads	基本
adt	期待
adu	芖
adv	基建
adw	基
adx	茂
ady	莽
aea	功臣
aeb	菔
aec	功能
aed	散布
aee	荔
aef	功夫
aeg	苴
aeh	散步
aei	散光
aej	薶
aek	茄
ael	菜园
aem	苏丹
aen	散发
aeo	功底
aep	菜农
aeq	功名
aer	藐
aes	菜
aet	功
aeu	藤
aev	荽
aew	苏
aex	功绩
aey	功率
afa	甘蔗
afb	邯
afc	芸
afd	甘
afe	劳动力
aff	芏
afg	东南亚
afh	某些
afi	蒜
afj	芉
afk	薹
afl	蕾
afm	贰
afn	苇
afo	䓇
afp	荸
afq	芜
afr	七十年代
afs	某
aft	著
afu	蔷
afv	甘肃
afw	芙
afx	区域经济
afy	或者说
aga	荆
agb	莱阳
agc	荎
agd	匡
age	莆
agf	芋
agg	七一
agh	廿
agi	花天酒地
agj	蕙
agk	蔌
agl	共青团
agm	芾
agn	七
ago	莱
agp	落到实处
agq	葬
agr	戒毒所
ags	茉
agt	廾
agu	苹
agv	萋
agw	董事会
agx	荑
agy	莱州
aha	蘧
ahb	 
ahc	 
ahd	菲
ahe	 
ahf	芷
ahg	菽
ahh	牙齿
ahi	芷江
ahj	䓬
ahk	熙
ahl	卧车
ahm	 
ahn	卧
aho	卧床
ahp	卧室
ahq	卧铺
ahr	邪气
ahs	 
aht	牙
ahu	 
ahv	 
ahw	某些人
ahx	茈
ahy	邪说
aia	茳
aib	范
aic	东台
aid	落成
aie	菹
aif	东南
aig	薄
aih	菠
aii	东
aij	东盟
aik	藻
ail	薀
aim	东山
ain	荡
aio	荧光灯
aip	落实
aiq	鸫
air	蒎
ais	菏
ait	落
aiu	汞
aiv	菬
aiw	东风
aix	薄弱
aiy	茫
aja	萌芽
ajb	蕞
ajc	 
ajd	莫
aje	萌
ajf	昔
ajg	蓝天
ajh	划
aji	划清
ajj	菖
ajk	 
ajl	蔓
ajm	䖁
ajn	萌发
ajo	草料
ajp	草案
ajq	葛
ajr	募捐
ajs	草木
ajt	蓝
aju	茧
ajv	郾
ajw	划分
ajx	菎
ajy	划为
aka	勤劳
akb	葺
akc	区别对待
akd	叵
ake	鄞县
akf	革
akg	勤
akh	匮
aki	苦口婆心
akj	或是
akk	颧
akl	区别轻重缓急
akm	莴
akn	勤快
ako	鞭炮
akp	其中之一
akq	鞍钢
akr	鞭挞
aks	切中要害
akt	匮乏
aku	燕
akv	 
akw	革命
akx	 
aky	或许
ala	基因工程
alb	世界卫生组织
alc	世界观
ald	蔑
ale	菌肥
alf	苗
alg	世界形势
alh	世界上
ali	世界水平
alj	莗
alk	匣
all	苗圃
alm	范围内
aln	葸
alo	 
alp	莲
alq	萝
alr	世界的
als	世界杯
alt	菌
alu	英国首相
alv	匦
alw	世界人民
alx	世界经济
aly	世界市场
ama	黄花
amb	黄陂
amc	英勇
amd	英
ame	蓇
amf	苖
amg	茼
amh	匝
ami	黄河
amj	英里
amk	苘
aml	英国
amm	黄山
amn	共同发展
amo	 
amp	共同富裕
amq	苋
amr	共同推出
ams	英模
amt	共同利益
amu	贡
amv	共同努力
amw	黄
amx	共同维护
amy	英文
ana	苠
anb	艺
anc	 
and	巨
ane	 
anf	蔚
ang	巨型
anh	蔬
ani	基层党组织
anj	蒸发量
ank	薜
anl	世界
anm	贳
ann	蕊
ano	 
anp	巨额
anq	蔚然
anr	 
ans	艺术
ant	芯片
anu	芯
anv	世
anw	蓼
anx	世纪
any	忒
aoa	蔗
aob	 
aoc	 
aod	营业厅
aoe	蕿
aof	工业城市
aog	薱
aoh	工业战线
aoi	工业污染
aoj	营业时间
aok	营业员
aol	工业界
aom	 
aon	工业局
aoo	敬业精神
aop	营业额
aoq	菧
aor	营业执照
aos	蘑
aot	工业生产
aou	炗
aov	薮
aow	工业化
aox	工业经济
aoy	工业效益
apa	荣获
apb	蒙阴
apc	蒙骗
apd	菪
ape	劳
apf	蒙
apg	莹
aph	菅
api	荥
apj	萤
apk	营
apl	荤
apm	蒙山
apn	茕
apo	荧
app	切实安排
apq	莺
apr	切实抓好
aps	荣
apt	荦
apu	芝
apv	营建
apw	蓉
apx	萦
apy	营房
aqa	芪
aqb	苑
aqc	芶
aqd	蔚然成风
aqe	萏
aqf	菳
aqg	葡
aqh	㔰
aqi	警觉
aqj	荀
aqk	敬
aql	警车
aqm	苟同
aqn	苞
aqo	菊
aqp	警察
aqq	警钟
aqr	葱
aqs	匹配
aqt	获
aqu	芕
aqv	匹
aqw	芡
aqx	基金组织
aqy	芍
ara	区区
arb	葼
arc	葩
ard	菝
are	区县
arf	苩
arg	瓯
arh	㔸
ari	区
arj	芹
ark	匠
arl	荡气回肠
arm	区内
arn	匠心
aro	 
arp	世乒赛
arq	欧
arr	落后的
ars	东拼西凑
art	萆
aru	艾
arv	苛捐杂税
arw	殴
arx	 
ary	薂
asa	艺术节
asb	基本职能
asc	基本观点
asd	基本原则
ase	基本力量
asf	茜
asg	苯
ash	葙
asi	基本法
asj	艼
ask	苛
asl	艺术团
asm	基本内容
asn	基本情况
aso	基本精神
asp	艺术家
asq	基本解决
asr	菥
ass	基本要求
ast	基本条件
asu	㭉
asv	基本建设
asw	菘
asx	基本经验
asy	基本方针
ata	苌
atb	莠
atc	获得通过
atd	医
ate	医用
atf	芊
atg	董
ath	蓰
ati	医学
atj	莉
atk	医嘱
atl	蓖
atm	薇
atn	鞠躬尽瘁
ato	蕃
atp	菲律宾
atq	藜
atr	莪
ats	医术
att	医生
atu	䒘
atv	萎
atw	工程公司
atx	蘩
aty	攻
aua	攻关项目
aub	蒴
auc	劳资双方
aud	营养不良
aue	花前月下
auf	苙
aug	医疗事故
auh	工资卡
aui	共产党员
auj	薏
auk	菩
aul	蕲
aum	蔽
aun	翘首以待
auo	 
aup	莫逆之交
auq	茨
aur	工资制度
aus	薪
aut	蒺
auu	东北部
auv	蒹
auw	蔺
aux	工资级别
auy	共产主义
ava	切莫
avb	艽
avc	巧妇难为无米之炊
avd	菇
ave	茛
avf	荨
avg	切开
avh	 
avi	萧
avj	 
avk	茹
avl	菑
avm	萧山
avn	切忌
avo	切断
avp	切实
avq	切勿
avr	芀
avs	 
avt	切
avu	 
avv	茘
avw	董建华
avx	 
avy	芄
awa	荟萃
awb	苍
awc	蓊
awd	茯
awe	恭贺
awf	蔡
awg	葵
awh	莜
awi	工作小组
awj	芥
awk	葆
awl	巩固
awm	共同
awn	恭
awo	花粉
awp	共祝
awq	共勉
awr	工作报告
aws	茶
awt	荏
awu	共
awv	芬
aww	巫
awx	花
awy	恐
axa	荭
axb	芎
axc	节约能源
axd	药厂
axe	药用
axf	荮
axg	莼
axh	苐
axi	蕴涵
axj	蕴
axk	药品
axl	 
axm	蒳
axn	䒛
axo	药店
axp	世纪之交
axq	药
axr	 
axs	药材
axt	芗
axu	苺
axv	 
axw	节约人力物力
axx	荜
axy	药剂
aya	芦苇
ayb	工商联
ayc	茺
ayd	A
aye	蘐
ayf	䓂
ayg	莫衷一是
ayh	苄
ayi	弋
ayj	蔼
ayk	蓑
ayl	工商界
aym	荒山
ayn	荒
ayo	工商业
ayp	匾额
ayq	鸢
ayr	芳
ays	其主要原因是
ayt	蔟
ayu	蒂
ayv	莨
ayw	萃
ayx	蓄
ayy	荒谬
baa	职工工资
bab	职工队伍
bac	 
bad	出其不意
bae	 
baf	职工教育
bag	陈列
bah	陈旧
bai	陈
baj	隁
bak	聝
bal	 
bam	 
ban	职工收入
bao	陈腐
bap	陕甘宁边区
baq	 
bar	防范措施
bas	陈述
bat	孤芳自赏
bau	 
bav	 
baw	职工代表
bax	 
bay	聀
bba	孕期
bbb	子
bbc	陬
bbd	孜孜不倦
bbe	 
bbf	孕
bbg	孖
bbh	耶
bbi	 
bbj	 
bbk	 
bbl	 
bbm	聉
bbn	阤
bbo	 
bbp	子宫
bbq	耶稣
bbr	子孙后代
bbs	 
bbt	子长
bbu	子弟
bbv	子女
bbw	孩子们
bbx	子弹
bby	孕育
bca	陉
bcb	取出
bcc	聂
bcd	 
bce	取胜
bcf	取款
bcg	 
bch	聚餐
bci	聚
bcj	取暖
bck	孡
bcl	盈
bcm	 
bcn	聚居
bco	焣
bcp	 
bcq	取名
bcr	 
bcs	取样
bct	取得
bcu	职能部门
bcv	娶
bcw	取代
bcx	取缔
bcy	取
bda	隋
bdb	随队
bdc	耾
bdd	随感
bde	随
bdf	呄
bdg	聚在一起
bdh	阫
bdi	承
bdj	陌
bdk	随口
bdl	 
bdm	随同
bdn	 
bdo	 
bdp	随军
bdq	承包
bdr	承担
bds	随机
bdt	陌生
bdu	随着
bdv	随即
bdw	随便
bdx	陇
bdy	承诺
bea	孤胆英雄
beb	阻隔
bec	承受能力
bed	阻碍
bee	阻力
bef	阴雨
beg	阴
beh	阻止
bei	阴沉
bej	阴影
bek	 
bel	 
bem	 
ben	 
beo	 
bep	阻塞
beq	聣
ber	孟加拉
bes	阴极
bet	阞
beu	承受着
bev	隠
bew	承办人
bex	附加费
bey	阴谋
bfa	陵墓
bfb	陈规陋习
bfc	耺
bfd	孺
bfe	陵县
bff	陡坡
bfg	 
bfh	陡
bfi	际
bfj	阱
bfk	聐
bfl	陵园
bfm	陡峭
bfn	隯
bfo	 
bfp	 
bfq	阮
bfr	 
bfs	 
bft	陼
bfu	 
bfv	出卖灵魂
bfw	陵
bfx	 
bfy	出土文物
bga	职责范围
bgb	陆
bgc	 
bgd	卫
bge	耳边
bgf	═
bgg	隔开
bgh	耳
bgi	卫辉
bgj	卫星
bgk	隔
bgl	卫国
bgm	陋
bgn	陋习
bgo	隔断
bgp	陆军
bgq	阢
bgr	隔热
bgs	陕西
bgt	卫生
bgu	陕
bgv	 
bgw	耳朵
bgx	陆续
bgy	隔离
bha	隵
bhb	芔
bhc	陂
bhd	耻辱
bhe	 
bhf	 
bhg	耻
bhh	陟
bhi	 
bhj	 
bhk	屮
bhl	 
bhm	 
bhn	鼐
bho	 
bhp	除此之外
bhq	子虚乌有
bhr	 
bhs	 
bht	 
bhu	 
bhv	 
bhw	㞣
bhx	 
bhy	承上启下
bia	 
bib	函
bic	孤掌难鸣
bid	也没有
bie	陗
bif	函索
big	丞
bih	耳濡目染
bii	氶
bij	隙
bik	除尘器
bil	 
bim	㞼
bin	 
bio	 
bip	逊
biq	逊色
bir	函授
bis	 
bit	隲
biu	尕
biv	孙女
biw	函件
bix	 
biy	孙
bja	防暴警察
bjb	,
bjc	卫星通信
bjd	阳历
bje	 
bjf	陧
bjg	阳
bjh	刵
bji	阳光
bjj	 
bjk	(
bjl	 
bjm	隅
bjn	阳性
bjo	 
bjp	除暴安良
bjq	阴暗角落
bjr	阳泉
bjs	 
bjt	 
bju	阳新
bjv	也是如此
bjw	阳信
bjx	隰
bjy	及时调整
bka	职工
bkb	随叫随到
bkc	亟
bkd	陨石
bke	䧎
bkf	叾
bkg	职责
bkh	聩
bki	 
bkj	出口量
bkk	职员
bkl	出口国
bkm	陨
bkn	 
bko	职业
bkp	出口额
bkq	出口贸易
bkr	 
bks	职权
bkt	职务
bku	出口产品
bkv	 
bkw	职
bkx	 
bky	出口商品
bla	阵营
blb	孟子
blc	 
bld	 
ble	勐
blf	孟
blg	䧃
blh	阵
bli	出国深造
blj	 
blk	 
bll	 
blm	 
bln	 
blo	 
blp	阵容
blq	 
blr	阵势
bls	 
blt	 
blu	阵痛
blv	 
blw	阵风
blx	阵线
bly	阵亡
bma	出世
bmb	出院
bmc	出台
bmd	出厂
bme	聘用
bmf	祟
bmg	聘
bmh	出战
bmi	出海
bmj	出师
bmk	出
bml	出国
bmm	出山
bmn	出发
bmo	粜
bmp	出家
bmq	出色
bmr	出手
bms	 
bmt	出版
bmu	出资
bmv	出嫁
bmw	出售
bmx	出线
bmy	孭
bna	 
bnb	孔子
bnc	 
bnd	 
bne	 
bnf	了却
bng	乃至
bnh	了
bni	孔雀
bnj	也是
bnk	隦
bnl	也罢
bnm	 
bnn	孔
bno	聚乙烯
bnp	 
bnq	了解
bnr	随心所欲
bns	也要
bnt	乃
bnu	孞
bnv	也好
bnw	出以公心
bnx	了结
bny	也许
boa	职业工会
bob	出席了
boc	 
bod	出席大会
boe	 
bof	防火墙
bog	出席开幕式
boh	 
boi	职业学校
boj	 
bok	 
bol	职业辅导
bom	 
bon	 
boo	出席座谈会
bop	出席宴会的
boq	隣
bor	职业技术教育
bos	 
bot	 
bou	职业道德
bov	䧜
bow	出席会议
box	 
boy	耿
bpa	院落
bpb	院子
bpc	 
bpd	䢊
bpe	辸
bpf	院
bpg	取之于
bph	 
bpi	辽宁省
bpj	陀螺
bpk	辽
bpl	 
bpm	 
bpn	 
bpo	 
bpp	辽宁
bpq	耽
bpr	院所
bps	聍
bpt	院长
bpu	辽阔
bpv	 
bpw	聚宝盆
bpx	陀
bpy	耽误
bqa	隐藏
bqb	了解了
bqc	阿尔巴尼亚
bqd	聸
bqe	陷
bqf	聊城
bqg	了解到
bqh	隐瞒
bqi	聎
bqj	 
bqk	隐患
bql	 
bqm	 
bqn	孢
bqo	陱
bqp	除夕之夜
bqq	陊
bqr	陶
bqs	陶醉
bqt	聊
bqu	陶瓷
bqv	隐
bqw	隐含
bqx	承包经营
bqy	承包商
bra	 
brb	 
brc	孤
brd	函授大学
bre	 
brf	孤老
brg	隍
brh	 
bri	函授学院
brj	 
brk	 
brl	 
brm	䎺
brn	限制性
bro	 
brp	孤军
brq	隗
brr	附近的
brs	防护林
brt	陴
bru	孤立
brv	 
brw	阿拉伯
brx	 
bry	承担义务
bsa	职权范围
bsb	 
bsc	 
bsd	 
bse	 
bsf	陻
bsg	䧈
bsh	耵
bsi	陕西省
bsj	阿里
bsk	阿
bsl	▁
bsm	 
bsn	 
bso	随机应变
bsp	 
bsq	 
bsr	 
bss	 
bst	阿根廷
bsu	朶
bsv	阿姨
bsw	阿爸
bsx	 
bsy	 
bta	降
btb	取得了
btc	防御能力
btd	聒
bte	 
btf	陲
btg	隆
bth	阼
bti	降水
btj	联系电话
btk	出入口
btl	出租车
btm	出自内心
btn	出版发行
bto	出版业
btp	出版社
btq	亟待解决
btr	取得的
bts	随处可见
btt	隆重
btu	卫生部
btv	联系群众
btw	降低
btx	降级
bty	孜
bua	联营
bub	联产承包责任制
buc	联欢
bud	联
bue	隧
buf	联运
bug	取决于
buh	耳闻目睹
bui	隧洞
buj	障
buk	聪
bul	 
bum	联网
bun	随意性
buo	联席
bup	联赛
buq	联名
bur	联接
bus	联想
but	联系
buu	隧道
buv	联姻
buw	隘
bux	联络
buy	联谊
bva	限期
bvb	 
bvc	 
bvd	 
bve	限
bvf	隐姓埋名
bvg	限于
bvh	孻
bvi	䎼
bvj	限量
bvk	䧂
bvl	 
bvm	 
bvn	 
bvo	限度
bvp	限额
bvq	 
bvr	限制
bvs	 
bvt	 
bvu	限产
bvv	 
bvw	限价
bvx	 
bvy	 
bwa	联合攻关
bwb	除了
bwc	聡
bwd	降低成本
bwe	附加
bwf	附
bwg	除
bwh	除非
bwi	联合举办
bwj	阶
bwk	队员
bwl	联合国
bwm	险峻
bwn	子公司
bwo	附庸
bwp	除害
bwq	除外
bwr	附近
bws	阶梯
bwt	队长
bwu	出人意料
bwv	附录
bww	阶段
bwx	阶级
bwy	队
bxa	阶级基础
bxb	 
bxc	阶级矛盾
bxd	阶级友爱
bxe	聈
bxf	聪颖过人
bxg	陛下
bxh	 
bxi	乸
bxj	 
bxk	联络员
bxl	 
bxm	 
bxn	阶级性
bxo	 
bxp	阶级社会
bxq	 
bxr	 
bxs	出线权
bxt	联络处
bxu	联络部
bxv	 
bxw	 
bxx	陛
bxy	 
bya	及其
byb	孩子
byc	耳熟能详
byd	出言不逊
bye	䧇
byf	防震
byg	防毒
byh	防止
byi	及
byj	及时
byk	聤
byl	 
bym	 
byn	孩
byo	防火
byp	防守
byq	承认错误
byr	防护
bys	及格
byt	防
byu	防病
byv	 
byw	联谊会
byx	防线
byy	阴谋诡计
caa	巴勒斯坦
cab	 
cac	 
cad	颈
cae	劲
caf	 
cag	艰苦环境
cah	艰苦卓绝
cai	观花赏景
caj	弁
cak	 
cal	 
cam	戏曲
can	戏剧
cao	戏迷
cap	迳
caq	 
car	艰巨的
cas	颈椎
cat	劲敌
cau	劲头
cav	艰苦努力
caw	艰苦创业
cax	 
cay	戏
cba	双职工
cbb	 
cbc	 
cbd	 
cbe	 
cbf	 
cbg	欢聚一堂
cbh	邓
cbi	 
cbj	牟取暴利
cbk	 
cbl	 
cbm	 
cbn	 
cbo	 
cbp	 
cbq	 
cbr	 
cbs	 
cbt	牟取私利
cbu	 
cbv	 
cbw	马耳他
cbx	 
cby	预防为主
cca	 
ccb	参观了
ccc	又
ccd	又有
cce	双边
ccf	双城
ccg	又一
cch	马马虎虎
cci	双流
ccj	又是
cck	 
ccl	艰难困苦
ccm	艰难曲折
ccn	双层
cco	驻马店
ccp	斚
ccq	对台贸易
ccr	双手
ccs	又要
cct	双向
ccu	㕕
ccv	又如
ccw	桑拿
ccx	 
ccy	双
cda	 
cdb	参院
cdc	参观
cdd	叁
cde	参
cdf	参考
cdg	参与
cdh	参战
cdi	参演
cdj	参照
cdk	 
cdl	畚
cdm	参见
cdn	参展
cdo	参数
cdp	参赛
cdq	 
cdr	参拜
cds	 
cdt	参赞
cdu	参阅
cdv	 
cdw	马不停蹄
cdx	 
cdy	参谋
cea	参加革命
ceb	参加了
cec	 
ced	能否
cee	能力
cef	䏍
ceg	勇于
ceh	通
cei	能源
cej	能量
cek	通路
cel	通车
cem	通则
cen	勇敢
ceo	 
cep	通宵
ceq	能够
cer	通报
ces	 
cet	劝
ceu	通道
cev	 
cew	通信
cex	能
cey	通讯
cfa	对攻
cfb	通过了
cfc	对垒
cfd	对面
cfe	 
cff	圣
cfg	对于
cfh	对此
cfi	对流
cfj	对照
cfk	驱动器
cfl	 
cfm	对内
cfn	怼
cfo	对应
cfp	对视
cfq	对象
cfr	对手
cfs	对歌
cft	对策
cfu	对立
cfv	 
cfw	对付
cfx	对比
cfy	对
cga	驱
cgb	骤
cgc	骚
cgd	马
cge	驵
cgf	驱动
cgg	骊
cgh	马上
cgi	验光
cgj	骒
cgk	驶
cgl	骡
cgm	骋
cgn	骣
cgo	 
cgp	驼
cgq	驹
cgr	驳
cgs	骠
cgt	骄
cgu	骥
cgv	骎
cgw	验
cgx	 
cgy	骗
cha	 
chb	 
chc	能上能下
chd	 
che	难上加难
chf	 
chg	 
chh	 
chi	 
chj	 
chk	 
chl	 
chm	 
chn	 
cho	 
chp	 
chq	覌
chr	双目失明
chs	 
cht	 
chu	 
chv	 
chw	 
chx	 
chy	 
cia	能源工业
cib	 
cic	 
cid	 
cie	 
cif	台湾地区
cig	邓小平
cih	 
cii	台湾当局
cij	台湾是中国的一部分
cik	 
cil	 
cim	台湾同胞
cin	对流层
cio	 
cip	 
ciq	能源危机
cir	通常的
cis	观赏植物
cit	 
ciu	厼
civ	能源建设
ciw	能源供应
cix	 
ciy	 
cja	 
cjb	 
cjc	 
cjd	 
cje	 
cjf	巴里坤
cjg	 
cjh	 
cji	 
cjj	 
cjk	 
cjl	 
cjm	 
cjn	 
cjo	 
cjp	参照实行
cjq	 
cjr	 
cjs	对照检查
cjt	参照物
cju	 
cjv	 
cjw	 
cjx	 
cjy	 
cka	 
ckb	邰
ckc	 
ckd	 
cke	台胞
ckf	台
ckg	台下
ckh	台上
cki	台湾
ckj	台盟
ckk	台中
ckl	 
ckm	台山
ckn	怠
cko	炱
ckp	迨
ckq	台独
ckr	 
cks	枲
ckt	台币
cku	台北
ckv	 
ckw	台风
ckx	巼
cky	台商
cla	 
clb	 
clc	 
cld	 
cle	 
clf	 
clg	 
clh	驳回上诉
cli	 
clj	 
clk	 
cll	 
clm	双鸭山
cln	 
clo	 
clp	 
clq	 
clr	双轨制
cls	 
clt	 
clu	圅
clv	 
clw	 
clx	 
cly	 
cma	 
cmb	 
cmc	 
cmd	观感
cme	 
cmf	 
cmg	 
cmh	观点
cmi	观测
cmj	岊
cmk	 
cml	 
cmm	 
cmn	预见性
cmo	观摩
cmp	观察
cmq	观
cmr	观看
cms	 
cmt	 
cmu	貟
cmv	 
cmw	观念
cmx	 
cmy	观望
cna	预期
cnb	预防
cnc	巴马
cnd	预感
cne	 
cnf	预示
cng	难以理解
cnh	预
cni	预测
cnj	 
cnk	巴中
cnl	柔软
cnm	预见
cnn	予以
cno	预料
cnp	预定
cnq	预留
cnr	矛盾
cns	巴西
cnt	预算
cnu	柔道
cnv	难以忍受
cnw	预付
cnx	预约
cny	厶
coa	馵
cob	馺
coc	馻
cod	駀
coe	騪
cof	观摩教学
cog	馷
coh	駊
coi	观摩演出
coj	馹
cok	馽
col	駰
com	駉
con	駃
coo	騼
cop	遤
coq	馰
cor	馸
cos	騋
cot	馲
cou	駾
cov	駋
cow	观摩会
cox	 
coy	馼
cpa	 
cpb	 
cpc	观礼台
cpd	通宵达旦
cpe	观察力
cpf	参赛者
cpg	观察到
cph	 
cpi	 
cpj	 
cpk	观察员
cpl	 
cpm	 
cpn	 
cpo	 
cpp	观察家
cpq	 
cpr	参审制度
cps	 
cpt	参军入伍
cpu	观察站
cpv	 
cpw	 
cpx	 
cpy	 
cqa	驰名世界
cqb	允
cqc	难解难分
cqd	对外友协
cqe	欢腾
cqf	欢喜
cqg	对外开放
cqh	 
cqi	欢迎光临
cqj	 
cqk	欢呼
cql	 
cqm	 
cqn	鸡蛋
cqo	欢庆
cqp	欢迎宴会
cqq	欢迎
cqr	欢欣
cqs	鸡西
cqt	欢乐
cqu	对外关系
cqv	 
cqw	欢
cqx	对外经济
cqy	鸡
cra	 
crb	观看了
crc	 
crd	 
cre	矛盾加剧
crf	欢欣鼓舞
crg	 
crh	 
cri	矛盾激化
crj	 
crk	 
crl	 
crm	 
crn	对抗性
cro	 
crp	对抗赛
crq	 
crr	通报批评
crs	马拉松
crt	勇挑重担
cru	 
crv	 
crw	 
crx	 
cry	 
csa	 
csb	 
csc	 
csd	巴林右旗
cse	 
csf	 
csg	 
csh	 
csi	 
csj	 
csk	 
csl	 
csm	 
csn	 
cso	 
csp	 
csq	 
csr	 
css	通栏标题
cst	欢歌笑语
csu	能歌善舞
csv	 
csw	 
csx	 
csy	勇攀高峰
cta	预算草案
ctb	牟取
ctc	 
ctd	矣
cte	 
ctf	对得起
ctg	牟
cth	 
cti	预备党员
ctj	 
ctk	 
ctl	双重国籍
ctm	预算内
ctn	通知书
cto	难得糊涂
ctp	预选赛
ctq	预算外资金
ctr	难得的
cts	 
ctt	预备役
ctu	通知单
ctv	对答如流
ctw	对我们来说
ctx	预算编制
cty	通行证
cua	对冲基金
cub	 
cuc	 
cud	参差不齐
cue	 
cuf	 
cug	对症下药
cuh	 
cui	巴彦淖尔盟
cuj	 
cuk	 
cul	 
cum	 
cun	 
cuo	 
cup	 
cuq	 
cur	 
cus	 
cut	 
cuu	 
cuv	 
cuw	欢送仪式
cux	对立统一
cuy	巴音郭楞
cva	艰苦
cvb	艰险
cvc	艰难
cvd	 
cve	艰
cvf	 
cvg	 
cvh	 
cvi	 
cvj	 
cvk	 
cvl	 
cvm	 
cvn	 
cvo	 
cvp	 
cvq	 
cvr	 
cvs	 
cvt	 
cvu	艰辛
cvv	 
cvw	 
cvx	 
cvy	 
cwa	通信工程
cwb	通信卫星
cwc	巴拿马
cwd	驻华大使
cwe	通货膨胀
cwf	难过
cwg	难于
cwh	难点
cwi	难当
cwj	难题
cwk	难听
cwl	 
cwm	通信网
cwn	难以
cwo	难度
cwp	通信安全
cwq	难免
cwr	难看
cws	 
cwt	逡
cwu	难道
cwv	难忍
cww	驻华使馆
cwx	通信线路
cwy	难
cxa	 
cxb	 
cxc	又红又专
cxd	 
cxe	 
cxf	 
cxg	 
cxh	 
cxi	 
cxj	 
cxk	 
cxl	 
cxm	 
cxn	 
cxo	对比度
cxp	 
cxq	 
cxr	 
cxs	 
cxt	 
cxu	 
cxv	 
cxw	通缉令
cxx	 
cxy	 
cya	圣诞节
cyb	参议院
cyc	能文能武
cyd	观望态度
cye	 
cyf	通讯地址
cyg	双方表示
cyh	 
cyi	叉
cyj	蚤
cyk	通讯员
cyl	叉车
cym	通讯网络
cyn	圣诞快乐
cyo	 
cyp	通讯社
cyq	 
cyr	难言的苦衷
cys	对讲机
cyt	参谋长
cyu	驻京部队
cyv	通讯录
cyw	能说会道
cyx	通话费
cyy	双方认为
daa	不甘落后
dab	 
dac	有苦难言
dad	厮
dae	左边
daf	左
dag	矼
dah	砑
dai	礴
daj	㚏
dak	厪
dal	在世界上
dam	砸
dan	碟
dao	大工业
dap	礞
daq	布莱尔
dar	砹
das	尤其要
dat	硗
dau	百花奖
dav	砌
daw	礤
dax	成功经验
day	䂝
dba	 
dbb	顾及
dbc	太阳能
dbd	顾
dbe	大陆架
dbf	耷
dbg	矷
dbh	䂙
dbi	太阳光
dbj	㚎
dbk	 
dbl	 
dbm	础
dbn	胡子眉毛一把抓
dbo	破除迷信
dbp	顾客
dbq	不了解
dbr	有限的
dbs	故障检测
dbt	太阳系
dbu	顾问
dbv	厄
dbw	有限公司
dbx	原子弹
dby	不承认
dca	硁
dcb	夿
dcc	磉
dcd	碜
dce	鬃
dcf	友协
dcg	码
dch	肆虐
dci	不能满足
dcj	 
dck	唘
dcl	大观园
dcm	不能同意
dcn	雄性
dco	雄鹰
dcp	不能实现
dcq	大熊猫
dcr	不难看出
dcs	不难想象
dct	不对称
dcu	友
dcv	肆
dcw	雄
dcx	 
dcy	友谊
dda	大臣
ddb	大陆
ddc	套
ddd	磊
dde	大力
ddf	大地
ddg	碱
ddh	厦
ddi	大学
ddj	大量
ddk	大中
ddl	大连
ddm	硕
ddn	大局
ddo	大庆
ddp	大家
ddq	大多
ddr	存在的
dds	大楼
ddt	大面积
ddu	㚐
ddv	大姐
ddw	大会
ddx	大约
ddy	厌
dea	有功
deb	郁
dec	大受欢迎
ded	有感
dee	历
def	有
deg	胡
deh	有些
dei	耐用消费品
dej	有时
dek	历史
del	克服困难
dem	胡同
den	大力发展
deo	有数
dep	有害
deq	鹕
der	夯
des	有机
det	劯
deu	有关
dev	有如
dew	有偿
dex	历经
dey	有效
dfa	奔
dfb	大专院校
dfc	磕
dfd	圧
dfe	辱
dff	奎
dfg	三十一
dfh	矸
dfi	奈
dfj	夲
dfk	厈
dfl	夺回
dfm	不规则
dfn	夸
dfo	奉献精神
dfp	夺冠
dfq	达斡尔
dfr	不动摇
dfs	大规模
dft	奢
dfu	夺
dfv	三十九
dfw	硅谷
dfx	压缩
dfy	压
dga	研
dgb	砘
dgc	古巴
dgd	三大
dge	威胁
dgf	在一起
dgg	三
dgh	古
dgi	石油
dgj	硬
dgk	感
dgl	礓
dgm	碛
dgn	感情
dgo	感应
dgp	研究
dgq	厉
dgr	研制
dgs	古朴
dgt	厂
dgu	砰
dgv	威
dgw	硬件
dgx	戌
dgy	厂商
dha	戛
dhb	存
dhc	破
dhd	慧
dhe	甭
dhf	在
dhg	歪
dhh	在此
dhi	不
dhj	不是
dhk	丰
dhl	不畏
dhm	不同
dhn	不必
dho	不断
dhp	还
dhq	艳
dhr	存折
dhs	还要
dht	夏
dhu	还将
dhv	契
dhw	不仅
dhx	在编
dhy	在京
dia	耩
dib	耔
dic	耙
did	耨
die	硝
dif	耕
dig	春小麦
dih	耜
dii	耒
dij	耦
dik	 
dil	不少国家
dim	大学同学
din	耗尽
dio	耧
dip	大兴安岭
diq	 
dir	在党的领导下
dis	不清楚
dit	砂
diu	泵
div	䎩
diw	耠
dix	耗费
diy	耪
dja	大量工作
djb	厚
djc	 
djd	大是大非
dje	厚爱
djf	百
djg	碍
djh	砷
dji	不是没有
djj	夰
djk	 
djl	硕果累累
djm	石景山
djn	奄
djo	厘米
djp	厚礼
djq	碣
djr	大量的
djs	䂺
djt	大显身手
dju	面临着
djv	百姓
djw	百余
djx	礘
djy	厚望
dka	历史范畴
dkb	历史阶段
dkc	有口难辩
dkd	大吃大喝
dke	右边
dkf	右
dkg	大中型企业
dkh	历史上
dki	大中小
dkj	夼
dkk	历史唯物主义
dkl	有中国特色社会主义
dkm	大别山
dkn	历史性
dko	 
dkp	不足之处
dkq	 
dkr	历史的
dks	历史机遇
dkt	历史条件
dku	历史意义
dkv	 
dkw	三中全会
dkx	历史经验
dky	历史文化
dla	大罢工
dlb	在国际上
dlc	奋勇
dld	百思不得其解
dle	奋力
dlf	奋
dlg	碨
dlh	砗
dli	大国沙文主义
dlj	 
dlk	厍
dll	大团圆
dlm	在国内外
dln	奋发
dlo	 
dlp	三连冠
dlq	 
dlr	 
dls	在思想上
dlt	胡思乱想
dlu	奋斗
dlv	 
dlw	㎎
dlx	大团结
dly	 
dma	碘
dmb	冇
dmc	面对
dmd	碳
dme	而且
dmf	碉
dmg	硐
dmh	布
dmi	布满
dmj	而
dmk	 
dml	布置
dmm	原则同意
dmn	布局
dmo	大幅度
dmp	不败之地
dmq	砚
dmr	不同的
dms	耐酸
dmt	面向
dmu	页
dmv	不同寻常
dmw	而今
dmx	面纱
dmy	布朗
dna	碾
dnb	乭
dnc	不怕艰苦
dnd	臧
dne	威慑力量
dnf	成都
dng	䎁
dnh	嘏
dni	不敢当
dnj	尴
dnk	成员
dnl	成因
dnm	成败
dnn	盛情
dno	 
dnp	成灾
dnq	尥
dnr	砀
dns	成本
dnt	成长
dnu	怘
dnv	尢
dnw	尬
dnx	盛
dny	尤
doa	矿区
dob	不断取得
doc	砿
dod	矿石
doe	不断加强
dof	不断地
dog	不断更新
doh	 
doi	不断深入
doj	灰暗
dok	不断吸取
dol	盔
dom	矿山
don	不断发展
doo	矿业
dop	不断完善
doq	磷
dor	不断提高
dos	礳
dot	矿
dou	灰
dov	磄
dow	不断创造
dox	硝烟弥漫
doy	不应该
dpa	研究工作
dpb	研究院
dpc	 
dpd	达成
dpe	达县
dpf	牵动
dpg	碹
dph	达卡
dpi	达
dpj	大容量
dpk	研究中心
dpl	大客车
dpm	 
dpn	太空飞行
dpo	石家庄
dpp	研究室
dpq	碗
dpr	研究所
dps	达标
dpt	牵
dpu	牵头
dpv	 
dpw	研究人员
dpx	砣
dpy	研究课题
dqa	砥
dqb	克
dqc	 
dqd	兢
dqe	确
dqf	大包干
dqg	碒
dqh	大名鼎鼎
dqi	胡锦涛
dqj	克星
dqk	㚚
dql	面包车
dqm	不多见
dqn	耐久性
dqo	大多数
dqp	确定
dqq	有色金属
dqr	克拉
dqs	 
dqt	不外乎
dqu	不久前
dqv	碀
dqw	砍
dqx	 
dqy	矽
dra	大白菜
drb	研制出
drc	在所难免
drd	研制成功
dre	原貌
drf	有所增加
drg	砶
drh	斫
dri	愿
drj	有的是
drk	爽口
drl	原因
drm	原则
drn	大气层
dro	原料
drp	原定
drq	磈
drr	爽
drs	原本
drt	碑
dru	愿意
drv	原始
drw	成年人
drx	成反比
dry	愿望
dsa	大本营
dsb	不可阻挡
dsc	有可能
dsd	不可否认
dse	有机肥料
dsf	奇才
dsg	硒
dsh	厢
dsi	大西洋
dsj	碴
dsk	厅
dsl	不可思议
dsm	奇峰
dsn	奇怪
dso	原材料
dsp	不相容
dsq	不可忽视
dsr	不可缺少
dss	大检查
dst	奇特
dsu	㚓
dsv	奇妙
dsw	不可估量
dsx	有机结合
dsy	奇迹
dta	在短期内
dtb	邦
dtc	 
dtd	不得不
dte	帮助
dtf	寿
dtg	有利于
dth	砟
dti	大街小巷
dtj	有利时机
dtk	硌
dtl	硇
dtm	礇
dtn	砾
dto	不适应
dtp	砭
dtq	大自然
dtr	硪
dts	有利可图
dtt	有利条件
dtu	不知道
dtv	不咎既往
dtw	寿命
dtx	故乡
dty	故
dua	碰巧
dub	厥
duc	 
dud	㕇
due	磁力
duf	辜
dug	砬
duh	奋斗目标
dui	有关法规
duj	鹩
duk	碚
dul	有关国家
dum	三门峡
dun	磁性
duo	碰
dup	大奖赛
duq	有关负责人
dur	有益的
dus	磁极
dut	磁盘
duu	冭
duv	磏
duw	大部分
dux	磁
duy	有关方面
dva	 
dvb	大杂院
dvc	厩
dvd	不妨碍
dve	感召力
dvf	友好城市
dvg	大好事
dvh	 
dvi	碌
dvj	大好时机
dvk	 
dvl	友好国家
dvm	 
dvn	 
dvo	大杂烩
dvp	原始社会
dvq	 
dvr	 
dvs	原始森林
dvt	友好往来
dvu	友好关系
dvv	大姑娘
dvw	友好合作关系
dvx	成群结队
dvy	友好访问
dwa	砼
dwb	春联
dwc	不仅能够
dwd	不仅不
dwe	舂
dwf	奉献
dwg	奏
dwh	百分点
dwi	仄
dwj	春
dwk	存储器
dwl	泰国
dwm	泰山
dwn	矶
dwo	百货店
dwp	百分之
dwq	大使馆
dwr	砜
dws	不仅要
dwt	秦
dwu	春意
dwv	不仅如此
dww	雁
dwx	百分比
dwy	礁
dxa	 
dxb	㔫
dxc	 
dxd	不约而同
dxe	 
dxf	龙井
dxg	袭击
dxh	成绩斐然
dxi	在经济上
dxj	砩
dxk	龙口
dxl	有比较才能有鉴别
dxm	龙山
dxn	䂗
dxo	垄断
dxp	成绩突出
dxq	 
dxr	牵线搭桥
dxs	 
dxt	龙舟
dxu	龙头
dxv	破纪录
dxw	三结合
dxx	砒
dxy	袭
dya	有计划
dyb	太阳
dyc	硫
dyd	飙
dye	戍边
dyf	有效地
dyg	砫
dyh	唇亡齿寒
dyi	太
dyj	在这里
dyk	礅
dyl	盇
dym	 
dyn	态
dyo	态度
dyp	太空
dyq	成交金额
dyr	态势
dys	太极
dyt	在这种情况下
dyu	磅
dyv	在京召开
dyw	碎
dyx	戍
dyy	砇
eaa	加工工业
eab	加工出口区
eac	加工能力
ead	加工厂
eae	朦胧
eaf	腻
eag	肛
eah	臔
eai	胨
eaj	舁
eak	膒
eal	䑅
eam	朠
ean	脦
eao	加工业
eap	朦
eaq	䏘
ear	用其所长
eas	毁林
eat	 
eau	月工资
eav	㥯
eaw	毁
eax	 
eay	加工订货
eba	服药
ebb	郛
ebc	服
ebd	采取有效措施
ebe	服用
ebf	孚
ebg	䏪
ebh	边防战士
ebi	乳汁
ebj	 
ebk	乳品
ebl	 
ebm	乳山
ebn	乳
ebo	 
ebp	边防军
ebq	服饰
ebr	采取措施
ebs	 
ebt	服务
ebu	服装
ebv	 
ebw	服从
ebx	 
eby	乳房
eca	胫
ecb	 
ecc	腏
ecd	肥大
ece	肥胖
ecf	肥城
ecg	 
ech	受骗上当
eci	肥沃
ecj	蜰
eck	胎
ecl	肥田
ecm	肥肉
ecn	肥
eco	肥料
ecp	 
ecq	胎儿
ecr	肥皂
ecs	 
ect	胎盘
ecu	 
ecv	 
ecw	朘
ecx	 
ecy	肥效
eda	膸
edb	受不了
edc	肱
edd	胸有成竹
ede	胚胎
edf	胯
edg	加在一起
edh	胚
edi	 
edj	貊
edk	 
edl	 
edm	须
edn	胆大心细
edo	采矿业
edp	 
edq	胆大包天
edr	遥感技术
eds	䐀
edt	须知
edu	用不着
edv	爱厂如家
edw	腠
edx	胧
edy	肽
eea	月薪
eeb	脬
eec	月台
eed	朋友
eee	月
eef	舀
eeg	朋
eeh	膄
eei	月光
eej	 
eek	月中
eel	 
eem	服服帖帖
een	㽰
eeo	月底
eep	月初
eeq	鹏
eer	月报
ees	肝胆相照
eet	肋
eeu	月产
eev	脮
eew	胁
eex	膎
eey	月亮
efa	膹
efb	肚子
efc	肢
efd	胸无大志
efe	膨胀
eff	边远地区
efg	肚
efh	肝
efi	肤浅
efj	肼
efk	膨
efl	 
efm	腩
efn	肟
efo	肝炎
efp	脖
efq	朊
efr	肤质
efs	脚本
eft	豺
efu	寽
efv	膤
efw	肤
efx	边境线
efy	肘
ega	助理工程师
egb	肫
egc	县
egd	且
ege	助
egf	县城
egg	助理
egh	 
egi	悬浮
egj	受到影响
egk	膈
egl	 
egm	肺
egn	毁灭性
ego	县政府
egp	悬空
egq	县外
egr	助手
egs	办事机构
egt	办事处
egu	肺癌
egv	受到好评
egw	雎
egx	胰
egy	县市
eha	用药
ehb	 
ehc	叟
ehd	腓
ehe	用力
ehf	用地
ehg	胩
ehh	用具
ehi	用水
ehj	用电
ehk	用
ehl	用车
ehm	 
ehn	胪
eho	用煤
ehp	用家
ehq	用钱
ehr	用手
ehs	 
eht	用处
ehu	辵
ehv	 
ehw	用途
ehx	頿
ehy	用户
eia	䝣
eib	 
eic	 
eid	 
eie	䏴
eif	 
eig	胱
eih	 
eii	 
eij	肺活量
eik	 
eil	盥
eim	䐝
ein	爱沙尼亚
eio	 
eip	膛
eiq	助学金
eir	脳
eis	 
eit	办学条件
eiu	加油站
eiv	胆小如鼠
eiw	膌
eix	 
eiy	 
eja	 
ejb	胆子
ejc	力量对比
ejd	胆大
eje	 
ejf	㸓
ejg	胆
ejh	刖
eji	力量源泉
ejj	胆量
ejk	受影响
ejl	腽
ejm	腢
ejn	胆怯
ejo	 
ejp	力量之源
ejq	 
ejr	 
ejs	腂
ejt	腥
eju	 
ejv	 
ejw	 
ejx	䐊
ejy	胆识
eka	加工
ekb	架子
ekc	驾
ekd	加大
eke	肿胀
ekf	胸中无数
ekg	加
ekh	肿
eki	加深
ekj	加紧
ekk	臊
ekl	加固
ekm	贺
ekn	加快
eko	加料
ekp	迦
ekq	 
ekr	加热
eks	架
ekt	加入
eku	肿瘤
ekv	妿
ekw	贺信
ekx	加强
eky	袈
ela	膕
elb	爱国卫生运动
elc	 
eld	胭
ele	舅
elf	爱国者
elg	舆
elh	胛
eli	爱国激情
elj	 
elk	 
ell	 
elm	 
eln	腮
elo	爱国精神
elp	 
elq	边界争端
elr	爱国热情
els	胆固醇
elt	䐃
elu	边界冲突
elv	爵
elw	爱国人士
elx	爱国统一战线
ely	舆论
ema	腆
emb	胜败乃兵家常事
emc	 
emd	胦
eme	 
emf	爯
emg	爨
emh	帠
emi	 
emj	 
emk	采购员
eml	受贿罪
emm	悬崖峭壁
emn	膼
emo	 
emp	受贿案
emq	觅
emr	 
ems	 
emt	 
emu	 
emv	爱财如命
emw	肭
emx	悬崖绝壁
emy	 
ena	 
enb	㐍
enc	 
end	力克
ene	 
enf	甩卖
eng	力求
enh	腵
eni	脲
enj	力量
enk	䑀
enl	力图
enm	 
enn	劜
eno	力度
enp	 
enq	力争
enr	肠
ens	爱民模范
ent	力
enu	鼠
env	甩
enw	力促
enx	胒
eny	力主
eoa	 
eob	 
eoc	 
eod	 
eoe	 
eof	脏
eog	 
eoh	 
eoi	 
eoj	 
eok	 
eol	 
eom	 
eon	膔
eoo	腅
eop	 
eoq	膦
eor	 
eos	 
eot	 
eou	䊆
eov	膅
eow	腑
eox	 
eoy	脒
epa	边区
epb	边防
epc	受
epd	爱
epe	边
epf	腙
epg	腚
eph	 
epi	边沿
epj	 
epk	 
epl	爱国
epm	受贿
epn	爱心
epo	 
epp	受灾
epq	腕
epr	膑
eps	 
ept	 
epu	受益
epv	胺
epw	腔
epx	边缘
epy	受训
eqa	胝
eqb	郳
eqc	胜负难测
eqd	脆
eqe	胸脯
eqf	 
eqg	胰岛素
eqh	力争上游
eqi	朓
eqj	彩色电视机
eqk	朐
eql	 
eqm	 
eqn	胞
eqo	舄
eqp	胸襟
eqq	䏧
eqr	胸
eqs	 
eqt	 
equ	爱尔兰
eqv	㬹
eqw	肷
eqx	脆弱
eqy	豹
era	 
erb	朡
erc	胍
erd	遥感
ere	脚手架
erf	遥远
erg	胉
erh	肵
eri	腺
erj	 
erk	乳制品
erl	脾胃
erm	遥
ern	䏗
ero	 
erp	 
erq	貌
err	遥控
ers	脎
ert	脾
eru	悬挂着
erv	力挫群雄
erw	貌似
erx	䑈
ery	遥望
esa	 
esb	采取
esc	 
esd	采矿
ese	彩
esf	膘
esg	彩带
esh	股票上市
esi	采油
esj	彩电
esk	遥相呼应
esl	彩车
esm	采购
esn	 
eso	采煤
esp	采写
esq	彩色
esr	采摘
ess	彩票
est	 
esu	采
esv	腰
esw	膝
esx	采纳
esy	䝗
eta	胀
etb	服务队
etc	服务台
etd	服务态度
ete	胳膊
etf	腹地
etg	胜
eth	臼
eti	腹泻
etj	腹
etk	胳
etl	貔
etm	服务网
etn	县委书记
eto	服务业
etp	服务社
etq	胜负
etr	服务质量
ets	服务机构
ett	彡
etu	服务部
etv	腇
etw	服务体系
etx	服务费
ety	豸
eua	胼
eub	脱险
euc	 
eud	腾
eue	脱脂
euf	受益者
eug	胖
euh	 
eui	脱水
euj	臆
euk	脱
eul	脱困
eum	 
eun	腾飞
euo	脱粒
eup	妥善安置
euq	妥善解决
eur	 
eus	 
eut	妥善处理
euu	脱产
euv	膁
euw	脱贫
eux	䏲
euy	脱离
eva	 
evb	 
evc	䐚
evd	 
eve	腿
evf	妥
evg	肗
evh	 
evi	妥当
evj	 
evk	貂
evl	䐉
evm	 
evn	肍
evo	 
evp	 
evq	 
evr	㼏
evs	 
evt	爱好和平
evu	妥善
evv	 
evw	鵎
evx	 
evy	肒
ewa	股东
ewb	 
ewc	股
ewd	А
ewe	胗
ewf	脍
ewg	脸
ewh	办公桌
ewi	办
ewj	 
ewk	 
ewl	 
ewm	肌肉
ewn	肌
ewo	脸庞
ewp	办公室
ewq	脸色
ewr	股份制
ews	貅
ewt	办公自动化
ewu	用人单位
ewv	办好
eww	脞
ewx	а
ewy	股市
exa	 
exb	加强了
exc	 
exd	奚
exe	脂肪
exf	边疆地区
exg	腰缠万贯
exh	䏖
exi	边缘学科
exj	脂
exk	膙
exl	加强团结
exm	 
exn	加强民族团结
exo	 
exp	脱缰之马
exq	 
exr	 
exs	肺结核
ext	加强管理
exu	䐞
exv	 
exw	加强合作
exx	肶
exy	胟
eya	舆论工具
eyb	脑子
eyc	 
eyd	舆论压力
eye	用户服务
eyf	用户需求
eyg	胶囊
eyh	 
eyi	脑海
eyj	脐
eyk	朜
eyl	膻
eym	 
eyn	脉
eyo	胶粘
eyp	脱离实际
eyq	胶印
eyr	脑
eys	 
eyt	肪
eyu	膀
eyv	脱离群众
eyw	胶
eyx	臃
eyy	舆论认为
faa	示范区
fab	 
fac	雨花台
fad	堪
fae	霰
faf	卋
fag	霸王
fah	武警战士
fai	塔河
faj	卉
fak	霸
fal	㙹
fam	贲
fan	堞
fao	 
fap	塔斯社
faq	域名
far	地区的
fas	霸权
fat	堪称
fau	武警部队
fav	 
faw	塔
fax	地区经济
fay	运营商
fba	地区
fbb	献出了
fbc	 
fbd	地面
fbe	地膜
fbf	地址
fbg	地球
fbh	邗
fbi	地学
fbj	壭
fbk	凷
fbl	地图
fbm	地幔
fbn	地
fbo	进取精神
fbp	赤子之心
fbq	地铁
fbr	地质
fbs	地板
fbt	地处
fbu	地头
fbv	 
fbw	地位
fbx	地线
fby	圾
fca	运营
fcb	却
fcc	动能
fcd	动态
fce	动
fcf	运动
fcg	动画
fch	支点
fci	运河
fcj	索马里
fck	动员
fcl	盍
fcm	 
fcn	翅
fco	云烟
fcp	运
fcq	运销
fcr	魂
fcs	支柱
fct	埃
fcu	去
fcv	未能如愿
fcw	运作
fcx	运费
fcy	却说
fda	城区
fdb	十三陵
fdc	都不能
fdd	老太太
fde	雳
fdf	震
fdg	坧
fdh	坏
fdi	地面水
fdj	埯
fdk	震中
fdl	壥
fdm	需
fdn	城
fdo	博大精深
fdp	教研室
fdq	城镇
fdr	塬
fds	需要
fdt	地大物博
fdu	地矿部
fdv	老百姓
fdw	城堡
fdx	垅
fdy	城市
fea	十月革命
feb	增加了
fec	才貌双全
fed	老朋友
fee	堋
fef	埒
feg	运用于
feh	赤膊上阵
fei	动力学
fej	霾
fek	赤胆忠心
fel	未加思索
fem	协同
fen	增加收入
feo	增加数
fep	协定
feq	霓
fer	喜爱的
fes	地膜覆盖
fet	㔹
feu	动力装置
fev	 
few	协
fex	专用线
fey	协议
ffa	款式
ffb	走进了
ffc	坛
ffd	封面
ffe	十二月
fff	圭
ffg	二十一世纪
ffh	填
ffi	款
ffj	运动量
ffk	运动员
ffl	二十四
ffm	封山
ffn	恚
ffo	专卖店
ffp	填补
ffq	封锁
ffr	过去的
ffs	封顶
fft	堵
ffu	寺
ffv	封建
ffw	运动会
ffx	未雨绸缪
ffy	填充
fga	十七
fgb	起到了
fgc	垤
fgd	十三
fge	博
fgf	圩
fgg	二
fgh	十
fgi	干涉
fgj	垣
fgk	塥
fgl	十四
fgm	武夷山
fgn	十一届三中全会
fgo	垭
fgp	地下室
fgq	地下铁道
fgr	十年
fgs	真理标准
fgt	二千
fgu	坪
fgv	十九
fgw	十分
fgx	二级
fgy	十六
fha	墟
fhb	趣
fhc	坡
fhd	霏
fhe	趄
fhf	直
fhg	址
fhh	赴
fhi	趟
fhj	趁早
fhk	坫
fhl	盐
fhm	起见
fhn	武
fho	走廊
fhp	真实
fhq	趋
fhr	赵
fhs	武术
fht	趱
fhu	走
fhv	超
fhw	真
fhx	超级
fhy	圤
fia	示范
fib	增添了
fic	未能
fid	却没有
fie	霄
fif	违法违纪
fig	霈
fih	土法上马
fii	未
fij	过渡时期
fik	老党员
fil	远洋轮船
fim	未见
fin	未必
fio	 
fip	未被
fiq	违法犯罪
fir	教学质量
fis	教学楼
fit	嫠
fiu	示
fiv	墚
fiw	示例
fix	未经
fiy	武汉市
fja	进攻
fjb	朝阳
fjc	进驻
fjd	进而
fje	井架
fjf	朝
fjg	坦
fjh	刊
fji	进水
fjj	亓
fjk	井
fjl	墁
fjm	进山
fjn	塌
fjo	进度
fjp	进
fjq	埸
fjr	专题报告
fjs	堁
fjt	进行
fju	朝着
fjv	进退
fjw	博览会
fjx	无照经营
fjy	进京
fka	喜获
fkb	露出
fkc	喜欢
fkd	颉
fke	袁
fkf	吉
fkg	埕
fkh	圳
fki	地中海
fkj	进口量
fkk	酃
fkl	进口国
fkm	埚
fkn	喜悦
fko	＃
fkp	吉祥
fkq	喜迎
fkr	鼓舞
fks	吉林
fkt	吉利
fku	鼓
fkv	喜好
fkw	元器件
fkx	哉
fky	远距离
fla	戴
flb	 
flc	 
fld	雷达
fle	㙕
flf	雷
flg	雷击
flh	戴上
fli	载波
flj	雷电
flk	雷鸣
fll	夁
flm	雷同
fln	二轻局
flo	运输业
flp	载客
flq	雷锋
flr	 
fls	 
flt	载重
flu	南辕北辙
flv	塿
flw	载体
flx	载
fly	塄
fma	献花
fmb	南阳
fmc	南通
fmd	南面
fme	南边
fmf	老同志
fmg	垌
fmh	圸
fmi	南海
fmj	南昌
fmk	 
fml	南国
fmm	井冈山
fmn	垲
fmo	 
fmp	南宁
fmq	境内外
fmr	 
fms	南极
fmt	献身
fmu	献
fmv	 
fmw	协同作战
fmx	献给
fmy	坝
fna	专项
fnb	㐊
fnc	喜忧参半
fnd	场面
fne	专用
fnf	䨒
fng	无愧于
fnh	霞
fni	墀
fnj	专题
fnk	霹
fnl	专辑
fnm	场内
fnn	圯
fno	专业
fnp	专家
fnq	场馆
fnr	声
fns	专栏
fnt	专利
fnu	志
fnv	亏
fnw	块
fnx	坭
fny	专
foa	墌
fob	郝
foc	专业对口
fod	頳
foe	赤脚
fof	赫
fog	进度表
foh	覝
foi	塘沽
foj	土库曼
fok	 
fol	 
fom	赤峰
fon	赤壁
foo	埮
fop	赤字
foq	专业银行
for	专业技术
fos	 
fot	圹
fou	赤
fov	塘
fow	专业化
fox	烖
foy	专业户
fpa	考察工作
fpb	勃
fpc	 
fpd	过硬
fpe	十字架
fpf	垸
fpg	壹
fph	过目
fpi	过
fpj	过时
fpk	辻
fpl	毂
fpm	索赔
fpn	真实性
fpo	壶
fpp	超额完成
fpq	过多
fpr	过后
fps	索要
fpt	过程
fpu	过关
fpv	吉祥如意
fpw	壳
fpx	索
fpy	过高
fqa	坻
fqb	元
fqc	均能
fqd	顽
fqe	无力
fqf	无需
fqg	元素
fqh	远眺
fqi	无法
fqj	元旦
fqk	鼋
fql	顽固
fqm	均由
fqn	雹
fqo	无数
fqp	远
fqq	无锡
fqr	元气
fqs	均可
fqt	远程
fqu	均
fqv	无
fqw	坎
fqx	无疑
fqy	无论
fra	朝气蓬勃
frb	违反了
frc	坂
frd	雨后春笋
fre	地质力学
frf	支持者
frg	垢
frh	圻
fri	地质学
frj	直接影响
frk	 
frl	无所畏惧
frm	十年内乱
frn	地热发电
fro	 
frp	真抓实干
frq	直接贸易
frr	直接投资
frs	动手术
frt	埤
fru	走后门
frv	十年如一日
frw	老年人
frx	直接经济损失
fry	坼
fsa	土木工程
fsb	 
fsc	都可能
fsd	无可奈何
fse	 
fsf	堙
fsg	南柯一梦
fsh	霜
fsi	吉林省
fsj	规模最大
fsk	坷
fsl	无可置疑
fsm	 
fsn	 
fso	 
fsp	无本之木
fsq	需要解决
fsr	专机抵达
fss	霖
fst	动植物
fsu	雬
fsv	土木建筑
fsw	零配件
fsx	栽
fsy	霸权主义
fta	走向世界
ftb	教
ftc	才能
ftd	才有
fte	才
ftf	霆
ftg	考
fth	埏
fti	教学
ftj	者
ftk	过程中
ftl	动物园
ftm	垧
ftn	圪
fto	二季度
ftp	考察
ftq	博物馆
ftr	教授
fts	都要
ftt	教委
ftu	二等奖
ftv	都好
ftw	老公
ftx	老
fty	坆
fua	埋头苦干
fub	干部队伍
fuc	 
fud	增大
fue	丧
fuf	幸
fug	垃
fuh	干部战士
fui	增添
fuj	境
fuk	培
ful	增
fum	境内
fun	增收
fuo	过半数
fup	幸福
fuq	增多
fur	丧失
fus	培植
fut	增长
fuu	培养
fuv	霎
fuw	增值
fux	增强
fuy	培训
fva	雪花
fvb	 
fvc	 
fvd	雪原
fve	垠
fvf	雪
fvg	未婚妻
fvh	壗
fvi	埭
fvj	 
fvk	 
fvl	封建思想
fvm	雪山
fvn	城建局
fvo	封建迷信
fvp	埽
fvq	 
fvr	雪白
fvs	 
fvt	雪片
fvu	干群关系
fvv	老奶奶
fvw	超媒体
fvx	进退维谷
fvy	封建主义
fwa	规范
fwb	截取
fwc	十分艰巨
fwd	截面
fwe	无人驾驶
fwf	替
fwg	截至
fwh	截止
fwi	夫
fwj	零星
fwk	老八路
fwl	十分困难
fwm	规
fwn	埠
fwo	截断
fwp	规定
fwq	截留
fwr	替换
fws	垛
fwt	规律
fwu	规章
fwv	夫妇
fww	赍
fwx	规约
fwy	零
fxa	 
fxb	 
fxc	无线通信
fxd	超级大国
fxe	坳
fxf	违纪违法
fxg	堟
fxh	塡
fxi	增强党性
fxj	无线电
fxk	教练员
fxl	无线连接
fxm	无线网
fxn	城乡居民
fxo	 
fxp	老红军
fxq	 
fxr	顽强拼搏
fxs	教练机
fxt	违纪行为
fxu	老弱病残
fxv	无线寻呼
fxw	二级企业
fxx	城乡经济
fxy	坶
fya	教育工作
fyb	教育子女
fyc	地方戏
fyd	超高压
fye	裁
fyf	霅
fyg	培训班
fyh	教育战线
fyi	圡
fyj	霭
fyk	壤
fyl	教育界
fym	地方财政
fyn	垓
fyo	塆
fyp	裁定
fyq	无记名投票
fyr	雱
fys	超文本
fyt	坊
fyu	雯
fyv	城市建设
fyw	坑
fyx	地方经济
fyy	坟
gaa	形式
gab	邢
gac	开通
gad	琪
gae	形
gaf	开支
gag	玒
gah	琊
gai	弄清
gaj	弄
gak	开
gal	开罗
gam	瑛
gan	开发
gao	开业
gap	形容
gaq	璥
gar	形势
gas	开机
gat	开往
gau	开关
gav	开始
gaw	珙
gax	开张
gay	开放
gba	击落
gbb	一阵子
gbc	㻓
gbd	顿感
gbe	击毁
gbf	 
gbg	珥
gbh	 
gbi	开除党籍
gbj	击
gbk	击中
gbl	 
gbm	互联网
gbn	顿
gbo	 
gbp	击穿
gbq	 
gbr	 
gbs	 
gbt	副院长
gbu	 
gbv	击退
gbw	现阶段
gbx	击毙
gby	 
gca	到期
gcb	致函
gcc	 
gcd	到达
gce	致力
gcf	至
gcg	玛
gch	至此
gci	至少
gcj	致电
gck	珆
gcl	 
gcm	五台山
gcn	致以
gco	到底
gcp	致富
gcq	至多
gcr	到手
gcs	到校
gct	到处
gcu	致癌
gcv	 
gcw	至今
gcx	 
gcy	㺨
gda	⒎
gdb	形成了
gdc	正确对待
gdd	△
gde	瑚
gdf	〇
gdg	⒌
gdh	环
gdi	天
gdj	蚕
gdk	吞
gdl	◇
gdm	顼
gdn	忝
gdo	天麻
gdp	＆
gdq	天然
gdr	「
gds	琦
gdt	⒈
gdu	㺯
gdv	⒐
gdw	环保
gdx	珑
gdy	天文
gea	青工
geb	青联
gec	静观
ged	表面
gee	静脉
gef	青
geg	瑗
geh	甫
gei	豕
gej	表明
gek	珈
gel	静默
gem	靓
gen	表情
geo	逐鹿
gep	逐
geq	静
ger	瑶
ges	表格
get	玏
geu	表
gev	表妹
gew	逐个
gex	逐级
gey	表率
gfa	玩艺
gfb	带动了
gfc	珐
gfd	表示感谢
gfe	现场办公
gff	珪
gfg	更进一步
gfh	玕
gfi	环境污染
gfj	于是
gfk	于
gfl	盂
gfm	表示同意
gfn	玮
gfo	平均数
gfp	迂
gfq	玩
gfr	副教授
gfs	 
gft	表示赞赏
gfu	环境意识
gfv	环境建设
gfw	环境保护
gfx	天无绝人之路
gfy	责无旁贷
gga	一项
ggb	带来了
ggc	琶
ggd	一套
gge	琢
ggf	一直
ggg	王
ggh	五
ggi	球
ggj	一是
ggk	球员
ggl	一
ggm	一同
ggn	瑟
ggo	一类
ggp	一定
ggq	一角
ggr	一年
ggs	一样
ggt	一种
ggu	一次
ggv	一群
ggw	琴
ggx	琵
ggy	珏
gha	琥
ghb	下降
ghc	玻
ghd	正
ghe	正月
ghf	下去
ghg	焉
ghh	正餐
ghi	下
ghj	正是
ghk	玷
ghl	一些国家
ghm	与此同时
ghn	丐
gho	政府
ghp	逐步实现
ghq	璨
ghr	正气
ghs	政权
ght	政
ghu	到目前为止
ghv	正如
ghw	一些人
ghx	下乡
ghy	㺪
gia	正常工作
gib	求职
gic	 
gid	逐渐成为
gie	救助
gif	正常运行
gig	来源于
gih	政治上
gii	青海省
gij	求是
gik	政治路线
gil	亚洲国家
gim	琐
gin	政治局委员
gio	救火
gip	救灾
giq	政治解决
gir	青少年
gis	政法机关
git	副省长
giu	政治部
giv	求婚
giw	正常人
gix	政治经济
giy	救
gja	理工
gjb	惠阳
gjc	更能
gjd	更大
gje	更加
gjf	理
gjg	亘
gjh	惠
gji	更深
gjj	更是
gjk	丌
gjl	瑥
gjm	理由
gjn	更快
gjo	理应
gjp	来临之际
gjq	更多
gjr	更
gjs	理想
gjt	更长
gju	更新
gjv	更好
gjw	理念
gjx	琨
gjy	璟
gka	事项
gkb	带队
gkc	融通
gkd	带有
gke	琄
gkf	吾
gkg	带来
gkh	囊
gki	整
gkj	吞吐量
gkk	卅
gkl	副
gkm	融
gkn	事情
gko	速度
gkp	带
gkq	事儿
gkr	吏
gks	整机
gkt	事务
gku	豆
gkv	事
gkw	整个
gkx	束缚
gky	速率
gla	 
glb	画
glc	 
gld	画面
gle	 
glf	五四运动
glg	一国两制
glh	玾
gli	柬
glj	 
glk	卌
gll	画图
glm	画册
gln	画展
glo	画廊
glp	琏
glq	㻿
glr	画报
gls	 
glt	画笔
glu	两国关系
glv	㻲
glw	两国人民
glx	㼈
gly	正因为
gma	遭
gmb	下岗职工
gmc	两难
gmd	瑞
gme	遭受
gmf	再
gmg	遭到
gmh	两眼
gmi	刺
gmj	遭遇
gmk	下岗员工
gml	两国
gmm	珊
gmn	现已
gmo	再度
gmp	现实
gmq	现
gmr	严峻的
gms	′
gmt	现行
gmu	责
gmv	再婚
gmw	两
gmx	两级
gmy	丽
gna	珉
gnb	㐏
gnc	 
gnd	琚
gne	恶性肿瘤
gnf	殖民地
gng	与
gnh	瑕
gni	㝳
gnj	到那时
gnk	开发中心
gnl	 
gnm	致以崇高的敬意
gnn	瓦
gno	 
gnp	一臂之力
gnq	瓦解
gnr	戸
gns	 
gnt	开发利用
gnu	忢
gnv	丂
gnw	与会
gnx	开发费
gny	副书记
goa	政府工作报告
gob	政府职能
goc	 
god	严
goe	来料加工
gof	王府井
gog	亚
goh	来此
goi	来
goj	来临
gok	晋中
gol	来回
gom	赉
gon	恶性
goo	琰
gop	严密
goq	璘
gor	来看
gos	严格
got	来自
gou	政府部门
gov	瑭
gow	来信
gox	灭绝
goy	来说
gpa	 
gpb	一定限度
gpc	一定能够
gpd	辷
gpe	事实胜于雄辩
gpf	琮
gpg	事实表明
gph	事实上
gpi	两袖清风
gpj	一定是
gpk	 
gpl	珲
gpm	一视同仁
gpn	现实情况
gpo	万家灯火
gpp	一审宣判
gpq	琬
gpr	一定的
gps	一定要
gpt	现实生活
gpu	现实意义
gpv	囊空如洗
gpw	琛
gpx	严守纪律
gpy	事实证明
gqa	殊荣
gqb	殛
gqc	殆
gqd	五角大楼
gqe	万
gqf	残
gqg	琻
gqh	迈步
gqi	歹
gqj	列
gqk	趸
gql	列车
gqm	殃
gqn	殆尽
gqo	列席
gqp	迈
gqq	殉
gqr	殊
gqs	残酷
gqt	熬
gqu	殚
gqv	兀
gqw	殓
gqx	死
gqy	玖
gra	更年期
grb	一揽子
grc	天气预报
grd	碧
gre	 
grf	素质教育
grg	珀
grh	 
gri	珠
grj	 
grk	豆制品
grl	一年四季
grm	五指山
grn	形势发展
gro	开拓精神
grp	珠宝
grq	瑰
grr	一把手
grs	 
grt	束手待毙
gru	开拓前进
grv	一拍即合
grw	青年人
grx	碧绿
gry	五年计划
gsa	到本世纪末
gsb	末了
gsc	 
gsd	互相帮助
gse	来样加工
gsf	互相支持
gsg	严要求
gsh	玎
gsi	末
gsj	亍
gsk	珂
gsl	 
gsm	平顶山
gsn	末尾
gso	 
gsp	灭顶之灾
gsq	 
gsr	严格的
gss	琳
gst	═
gsu	严格遵守
gsv	 
gsw	互相促进
gsx	严格纪律
gsy	理想主义
gta	一等功
gtb	琇
gtc	再生能源
gtd	一条龙
gte	两条腿走路
gtf	瓒
gtg	珩
gth	 
gti	政策水平
gtj	严重影响
gtk	珞
gtl	璁
gtm	一番周折
gtn	副秘书长
gto	一季度
gtp	五笔字型
gtq	严重危害
gtr	严重的
gts	更重要的是
gtt	事务处理
gtu	麦
gtv	㻶
gtw	互利合作
gtx	玻利维亚
gty	玫
gua	事半功倍
gub	平阳
guc	平台
gud	夹
gue	平遥
guf	平
gug	副总理
guh	开阔眼界
gui	平常
guj	璋
guk	副产品
gul	璔
gum	平山
gun	一次性
guo	平庸
gup	平安
guq	夹角
gur	下半年
gus	平板
gut	平衡
guu	再立新功
guv	夹杂
guw	一部分
gux	副总经理
guy	平方
gva	一刀切
gvb	妻子
gvc	 
gvd	再好不过
gve	珢
gvf	更好地
gvg	惠灵顿
gvh	妻
gvi	琭
gvj	璅
gvk	玿
gvl	㼃
gvm	 
gvn	严肃性
gvo	㻏
gvp	开始实施
gvq	 
gvr	 
gvs	严肃查处
gvt	瑙
gvu	 
gvv	一如既往
gvw	开始使用
gvx	开始继续
gvy	严肃认真
gwa	玳
gwb	开创了
gwc	一个又一个
gwd	责任感
gwe	珍
gwf	与会者
gwg	瑜
gwh	整体上
gwi	整体水平
gwj	一个时期以来
gwk	珍贵
gwl	责任田
gwm	与会同志
gwn	玑
gwo	 
gwp	现代农业
gwq	一会儿
gwr	责任制
gws	一个样
gwt	现代科技
gwu	兲
gwv	玢
gww	现代化
gwx	责任编辑
gwy	玲
gxa	玛纳斯
gxb	互联
gxc	互通
gxd	素有
gxe	互助
gxf	再经过
gxg	互
gxh	纛
gxi	素
gxj	一贯坚持
gxk	毒品
gxl	正统思想
gxm	万维网
gxn	毒性
gxo	开绿灯
gxp	互补
gxq	毒枭
gxr	素质
gxs	互相
gxt	互利
gxu	毒
gxv	 
gxw	夷
gxx	玭
gxy	互访
gya	理论基础
gyb	班子
gyc	琉
gyd	一方面
gye	珳
gyf	天主教
gyg	斑
gyh	理论上
gyi	玉
gyj	再就是
gyk	琼
gyl	班车
gym	玉山
gyn	开放性
gyo	平方米
gyp	一夜之间
gyq	开户银行
gyr	璃
gys	玉林
gyt	班
gyu	玉兰
gyv	琅
gyw	副主任
gyx	班组
gyy	玟
haa	虐
hab	 
hac	 
had	睰
hae	虏
haf	虞城
hag	瞒
hah	頥
hai	 
haj	戱
hak	虞
hal	瞄
ham	䁐
han	虑
hao	虚
hap	虚实
haq	虚名
har	眍
has	虚构
hat	卡斯特罗
hau	瞄准
hav	虍
haw	虎
hax	眼花缭乱
hay	虔
hba	齖
hbb	齱
hbc	齝
hbd	齮
hbe	齨
hbf	￥
hbg	眲
hbh	䶥
hbi	 
hbj	齥
hbk	齞
hbl	齫
hbm	䶡
hbn	齓
hbo	 
hbp	齳
hbq	齺
hbr	齗
hbs	齼
hbt	齕
hbu	齴
hbv	 
hbw	齘
hbx	 
hby	齩
hca	皮革
hcb	上台阶
hcc	眼巴巴
hcd	颇
hce	皮肤
hcf	皯
hcg	皮带
hch	颇具
hci	皮
hcj	㓟
hck	眙
hcl	 
hcm	皮肉
hcn	瞲
hco	 
hcp	皹
hcq	颇多
hcr	悲观失望
hcs	皮棉
hct	眸
hcu	攴
hcv	㿪
hcw	睃
hcx	 
hcy	颇为
hda	具有划时代的意义
hdb	辈出
hdc	悲观
hdd	卓有成效
hde	 
hdf	睚
hdg	䀦
hdh	辈
hdi	非常
hdj	占有量
hdk	具有中国特色
hdl	具有国际先进水平
hdm	颇有同感
hdn	悲剧
hdo	 
hdp	 
hdq	斐然
hdr	 
hds	悲歌
hdt	具有重要意义
hdu	悲痛
hdv	目不忍睹
hdw	非凡
hdx	点面结合
hdy	悲哀
hea	 
heb	卡脖子
hec	颇受欢迎
hed	 
hee	 
hef	肯
heg	眀
heh	瞍
hei	 
hej	瞬时
hek	 
hel	䂃
hem	 
hen	 
heo	 
hep	瞬
heq	睨
her	䁘
hes	睬
het	䀐
heu	瞬间
hev	 
hew	 
hex	 
hey	 
hfa	 
hfb	 
hfc	歧
hfd	战无不胜
hfe	 
hff	眭
hfg	 
hfh	盰
hfi	目无法纪
hfj	 
hfk	睵
hfl	 
hfm	 
hfn	上进心
hfo	 
hfp	歧视
hfq	盶
hfr	 
hfs	虚无飘渺
hft	睹
hfu	䁄
hfv	 
hfw	睦
hfx	虚无缥缈
hfy	歧义
hga	上工
hgb	盹
hgc	上马
hgd	上
hge	睛
hgf	盱
hgg	上下
hgh	卡
hgi	叔
hgj	上映
hgk	上路
hgl	卡车
hgm	上网
hgn	忐
hgo	睐
hgp	上空
hgq	上旬
hgr	卡拉
hgs	上述
hgt	上升
hgu	上门
hgv	睫
hgw	上一个
hgx	上级
hgy	上市
hha	瞒上欺下
hhb	步子
hhc	步骤
hhd	频
hhe	 
hhf	止境
hhg	止
hhh	目
hhi	目光
hhj	 
hhk	目瞪口呆
hhl	丨
hhm	 
hhn	步履
hho	频度
hhp	虚虚实实
hhq	睍
hhr	步
hhs	目标
hht	步入
hhu	歨
hhv	目录
hhw	瞿
hhx	眦
hhy	卜
hia	 
hib	非法出版物
hic	 
hid	非洲大陆
hie	上当受骗
hif	 
hig	非常严重
hih	 
hii	非常满意
hij	非常明显
hik	 
hil	非洲国家
him	上涨幅度
hin	非常快
hio	非常广阔
hip	瞠
hiq	非常危险的
hir	非法所得
his	柴油机
hit	眇
hiu	非常痛快
hiv	非常好
hiw	非常任理事国
hix	非法经营
hiy	上海市
hja	卓著
hjb	桌子
hjc	 
hjd	桌面
hje	旧貌
hjf	卓
hjg	旧
hjh	此时此刻
hji	䁜
hjj	旧时
hjk	 
hjl	 
hjm	 
hjn	旧居
hjo	 
hjp	䁙
hjq	卓然
hjr	 
hjs	桌
hjt	睲
hju	 
hjv	 
hjw	旧货
hjx	卓绝
hjy	 
hka	战
hkb	点阵
hkc	战马
hkd	占有
hke	战胜
hkf	占
hkg	战事
hkh	占卜
hki	点滴
hkj	战时
hkk	瞣
hkl	战略
hkm	觇
hkn	乩
hko	点
hkp	鼎足之势
hkq	战争
hkr	占据
hks	战术
hkt	战役
hku	战斗
hkv	 
hkw	占领
hkx	战线
hky	点评
hla	 
hlb	战略防御
hlc	 
hld	战略研究
hle	䁌
hlf	盀
hlg	战略平衡
hlh	战略目标
hli	 
hlj	 
hlk	㔽
hll	战略思想
hlm	䁲
hln	战略性
hlo	鹶
hlp	战略家
hlq	 
hlr	卤
hls	战略要地
hlt	战略重点
hlu	战略决策
hlv	瞜
hlw	战略任务
hlx	 
hly	战略方针
hma	欳
hmb	 
hmc	 
hmd	眏
hme	 
hmf	上岗培训
hmg	上山下乡
hmh	 
hmi	非同小可
hmj	 
hmk	 
hml	 
hmm	 
hmn	卣
hmo	 
hmp	遉
hmq	 
hmr	 
hms	 
hmt	 
hmu	贞
hmv	非同寻常
hmw	 
hmx	 
hmy	眼见为实
hna	眠
hnb	瞰
hnc	步履艰难
hnd	鼎
hne	 
hnf	 
hng	肯尼亚
hnh	瞩目
hni	卢湾
hnj	 
hnk	䁹
hnl	 
hnm	凹
hnn	悲剧性
hno	 
hnp	 
hnq	鸬
hnr	卢
hns	 
hnt	瞩
hnu	鼎立
hnv	上层建筑
hnw	悲惨命运
hnx	步履维艰
hny	 
hoa	矌
hob	歯
hoc	 
hod	 
hoe	 
hof	 
hog	瞨
hoh	 
hoi	柴米油盐
hoj	 
hok	 
hol	 
hom	 
hon	 
hoo	睒
hop	 
hoq	瞵
hor	虚度年华
hos	 
hot	 
hou	 
hov	瞊
how	 
hox	 
hoy	眯
hpa	 
hpb	瞎子
hpc	 
hpd	瞎
hpe	肻
hpf	睆
hpg	睿
hph	虎视眈眈
hpi	 
hpj	瞑
hpk	 
hpl	睴
hpm	 
hpn	矃
hpo	 
hpp	 
hpq	眈
hpr	 
hps	眝
hpt	敹
hpu	 
hpv	㢟
hpw	旧社会
hpx	 
hpy	非官方
hqa	眂
hqb	覎
hqc	餐
hqd	瞻
hqe	 
hqf	䙷
hqg	 
hqh	餐桌
hqi	眺
hqj	战争时期
hqk	眗
hql	餐车
hqm	旧金山
hqn	非金属
hqo	䁩
hqp	 
hqq	眵
hqr	战争年代
hqs	 
hqt	覹
hqu	歺
hqv	睁
hqw	瞻仰
hqx	紫外线
hqy	眺望
hra	 
hrb	䁓
hrc	眅
hrd	上气不接下气
hre	眽
hrf	目的地
hrg	虚拟现实
hrh	盺
hri	虚拟光纤
hrj	 
hrk	 
hrl	瞴
hrm	 
hrn	目的性
hro	 
hrp	虚拟空间
hrq	䁛
hrr	瞎指挥
hrs	 
hrt	睥
hru	目的意义
hrv	 
hrw	眣
hrx	䁻
hry	䁶
hsa	 
hsb	 
hsc	 
hsd	 
hse	 
hsf	瞟
hsg	目标责任制
hsh	盯
hsi	 
hsj	瞫
hsk	㱒
hsl	 
hsm	 
hsn	战术导弹
hso	 
hsp	 
hsq	 
hsr	 
hss	桌椅板凳
hst	目标管理
hsu	上述问题
hsv	䁏
hsw	盯住
hsx	 
hsy	 
hta	 
htb	具备了
htc	 
htd	䀢
hte	歬
htf	睡
htg	上升到
hth	睡眠
hti	睡觉
htj	 
htk	䀩
htl	 
htm	上升幅度
htn	盵
hto	瞅
htp	眨
htq	 
htr	睋
hts	 
htt	具备条件
htu	非生产性
htv	 
htw	瞛
htx	䀲
hty	 
hua	 
hub	 
huc	 
hud	瞻前顾后
hue	战斗力
huf	上半场
hug	眫
huh	非亲非故
hui	 
huj	瞳
huk	 
hul	䁬
hum	 
hun	矙
huo	占总数的
hup	 
huq	 
hur	目前的
hus	战斗机
hut	眼前利益
huu	上半部
huv	瞬间即逝
huw	战斗堡垒
hux	睇
huy	 
hva	 
hvb	 
hvc	 
hvd	 
hve	眼
hvf	 
hvg	眼下
hvh	眼睛
hvi	眼光
hvj	眼里
hvk	眧
hvl	眼界
hvm	眼见
hvn	 
hvo	 
hvp	眼帘
hvq	眼镜
hvr	眼看
hvs	 
hvt	眼科
hvu	眼前
hvv	 
hvw	 
hvx	眼红
hvy	䀓
hwa	具体工作
hwb	龄
hwc	瞈
hwd	具有
hwe	上个月
hwf	具体规定
hwg	瞪
hwh	具体目标
hwi	 
hwj	上个星期
hwk	占人口总数
hwl	齿轮
hwm	具体内容
hwn	具体情况
hwo	虚假广告
hwp	具体实际
hwq	具体负责
hwr	具体措施
hws	具体要求
hwt	具备
hwu	具
hwv	盼
hww	具体
hwx	 
hwy	瞧
hxa	此项
hxb	 
hxc	 
hxd	砦
hxe	眑
hxf	些
hxg	此事
hxh	䀕
hxi	此举
hxj	此时
hxk	呰
hxl	 
hxm	赀
hxn	此
hxo	此类
hxp	此案
hxq	觜
hxr	此后
hxs	柴
hxt	此种
hxu	此次
hxv	姕
hxw	雌
hxx	紫
hxy	訾
hya	 
hyb	 
hyc	瞮
hyd	 
hye	 
hyf	 
hyg	步调一致
hyh	 
hyi	 
hyj	 
hyk	上帝啊
hyl	䁴
hym	 
hyn	占主导地位
hyo	 
hyp	 
hyq	 
hyr	眼高手低
hys	 
hyt	眆
hyu	䁤
hyv	䀶
hyw	上市公司
hyx	眩
hyy	盿
iaa	江苏
iab	江阴
iac	港台
iad	湛
iae	满脸
iaf	泔
iag	江
iah	举世瞩目
iai	江苏省
iaj	漠
iak	灌
ial	灌输
iam	潢
ian	汇
iao	港府
iap	涝
iaq	鸿
iar	沤
ias	柒
iat	浇
iau	渠道
iav	沏
iaw	洪
iax	汇编
iay	㳀
iba	洗耳恭听
ibb	汲取
ibc	滠
ibd	瀡
ibe	泐
ibf	池塘
ibg	洱
ibh	滍
ibi	涵
ibj	消除影响
ibk	凼
ibl	消防车
ibm	泏
ibn	池
ibo	 
ibp	海陆空
ibq	 
ibr	派出所
ibs	派出机构
ibt	漋
ibu	涵盖
ibv	 
ibw	滁
ibx	㶌
iby	汲
ica	泾
icb	汉子
icc	尚难预料
icd	渗
ice	涌
icf	汉城
icg	泽
ich	涌上
ici	治水
icj	流通量
ick	治
icl	治国
icm	治山
icn	汿
ico	溤
icp	汉字
icq	沇
icr	流通手段
ics	治本
ict	渗透
icu	治疗
icv	汉奸
icw	滩
icx	 
icy	汉
ida	湖区
idb	尖子
idc	汯
idd	深有感触
ide	湖
idf	涯
idg	沽
idh	沣
idi	尜
idj	淹
idk	湖口
idl	湖畔
idm	湎
idn	没有必要
ido	少而精
idp	
idq	尖锐
idr	源
ids	激励机制
idt	涛
idu	尖
idv	尖刀
idw	溱
idx	泷
idy	汰
iea	深加工
ieb	浮
iec	淝
ied	小朋友
iee	滔
ief	肖
ieg	沮
ieh	溲
iei	滔滔
iej	削
iek	浮躁
iel	灂
iem	浮雕
ien	水力发电
ieo	 
iep	逍
ieq	淣
ier	常用的
ies	浮桥
iet	淫
ieu	削减
iev	浽
iew	削价
iex	溪
iey	添加剂
ifa	灞
ifb	法院
ifc	法
ifd	濡
ife	潜力
iff	尘
ifg	汢
ifh	汗
ifi	污染
ifj	潮
ifk	洁
ifl	法国
ifm	法则
ifn	污
ifo	法庭
ifp	渤
ifq	沅
ifr	法制
ifs	小规模
ift	渚
ifu	党支部
ifv	 
ifw	潜
ifx	浅
ify	深圳市
iga	光荣
igb	沌
igc	光驱
igd	添
ige	清
igf	兴趣
igg	汪
igh	沔
igi	光学
igj	洹
igk	滞
igl	添置
igm	沛
ign	满天飞
igo	涞
igp	党政军
igq	耀
igr	举措
igs	沫
igt	举行
igu	浃
igv	兴建
igw	举
igx	光纤
igy	誉为
iha	滤
ihb	涉及
ihc	波
ihd	渄
ihe	小股
ihf	小雨
ihg	泪
ihh	涉
ihi	渺
ihj	淖
ihk	沾
ihl	波恩
ihm	浈
ihn	泸
iho	小康
ihp	小农
ihq	瀣
ihr	小看
ihs	 
iht	小
ihu	波兰
ihv	小姐
ihw	濉
ihx	小组
ihy	小说
iia	海淀区
iib	消除
iic	港澳台
iid	消耗
iie	消
iif	深深地
iig	水平
iih	海湾战争
iii	淼
iij	水果
iik	水路
iil	小汽车
iim	淌
iin	江泽民
iio	水库
iip	水灾
iiq	淡泊名利
iir	消失
iis	消极
iit	沙
iiu	水产
iiv	消退
iiw	消化
iix	消费
iiy	沝
ija	瀑
ijb	㵊
ijc	温柔
ijd	瀑布
ije	滥用
ijf	沓
ijg	汨
ijh	漫步
iji	漫游
ijj	温暖
ijk	浏览器
ijl	漫
ijm	温岭
ijn	溻
ijo	湿
ijp	温室
ijq	渴
ijr	光明的
ijs	清晰可见
ijt	滥
iju	水电站
ijv	混杂
ijw	混合
ijx	混
ijy	浊
ika	涉足其间
ikb	湒
ikc	浥
ikd	 
ike	涓
ikf	呇
ikg	满足于
ikh	汌
iki	 
ikj	渑
ikk	澡
ikl	举足轻重
ikm	涡
ikn	 
iko	溃烂
ikp	 
ikq	酒足饭饱
ikr	水中捞月
iks	满足要求
ikt	满口答应
iku	溃疡
ikv	 
ikw	演唱会
ikx	㕾
iky	海口市
ila	法轮功
ilb	小圈子
ilc	举国欢腾
ild	涸
ile	渭
ilf	泴
ilg	泗
ilh	㳌
ili	渐渐
ilj	単
ilk	洄
ill	小轿车
ilm	㵋
iln	㴓
ilo	 
ilp	涟
ilq	 
ilr	渐
ils	涃
ilt	 
ilu	汽车站
ilv	漊
ilw	泅
ilx	漯
ily	深思熟虑
ima	澧
imb	小册子
imc	测验
imd	湍
ime	滑
imf	溅
img	油
imh	汕
imi	油漆
imj	测
imk	尚
iml	油田
imm	瀴
imn	尚属
imo	油料
imp	测定
imq	海内外
imr	油气
ims	尚可
imt	测算
imu	汕头
imv	 
imw	涔
imx	测绘
imy	浿
ina	泯
inb	潺
inc	泥巴
ind	党性原则
ine	 
inf	漏
ing	渥
inh	湄
ini	漏洞
inj	漏电
ink	浺
inl	泼墨
inm	涮
inn	汜
ino	 
inp	瀈
inq	 
inr	汤
ins	 
int	泼
inu	深层次
inv	泦
inw	濯
inx	泥
iny	沁
ioa	渡
iob	海底隧道
ioc	 
iod	辉煌成就
ioe	少数服从多数
iof	渡过
iog	澲
ioh	 
ioi	淡水
ioj	消磨时光
iok	渡口
iol	瀵
iom	 
ion	漉
ioo	淡
iop	小康社会
ioq	淡然
ior	辉煌的
ios	灖
iot	㲿
iou	濂
iov	溏
iow	淡化
iox	 
ioy	洣
ipa	黉
ipb	学
ipc	常驻
ipd	学历
ipe	浓
ipf	尝
ipg	演
iph	涫
ipi	泶
ipj	溟
ipk	党
ipl	浑
ipm	觉
ipn	学习
ipo	深度
ipp	温家宝
ipq	沈
ipr	滨
ips	泞
ipt	喾
ipu	滓
ipv	学好
ipw	深
ipx	沱
ipy	深刻
iqa	满负荷
iqb	 
iqc	沟
iqd	澹
iqe	淊
iqf	渔场
iqg	淦
iqh	沟壑
iqi	洮
iqj	洵
iqk	浼
iql	渔轮
iqm	涣
iqn	泡
iqo	渔业
iqp	淘宝
iqq	沉甸甸
iqr	淘
iqs	 
iqt	漪
iqu	海外关系
iqv	浄
iqw	染色体
iqx	涉外经济
iqy	汐
ira	党的基本路线
irb	汹
irc	派对
ird	淆
ire	派
irf	激动
irg	泊
irh	沂
iri	洙
irj	举报电话
irk	派遣
irl	汽车
irm	海誓山盟
irn	汽
iro	滚瓜烂熟
irp	法制宣传
irq	少年儿童
irr	浙
irs	 
irt	派生
iru	法制意识
irv	法制建设
irw	党的领导
irx	党的纪律
iry	激
isa	法西斯
isb	溧阳
isc	消极怠工
isd	酒厂
ise	河边
isf	漂
isg	洒
ish	汀
isi	江西省
isj	潭
isk	河
isl	学术界
ism	河内
isn	学术性
iso	酒店
isp	酒家
isq	 
isr	淅
iss	淋
ist	漂移
isu	河北
isv	㴗
isw	漆
isx	湘乡
isy	沐
ita	洚
itb	沲
itc	海难
itd	活
ite	少
itf	浩
itg	党和政府
ith	省
iti	潲
itj	少量
itk	洛
itl	洫
itm	澳
itn	泺
ito	潘
itp	泛
itq	海外
itr	少年
its	涤
itt	滗
itu	澳门
itv	水利建设
itw	常委会
itx	海
ity	汷
iua	当前工作
iub	溯
iuc	㶒
iud	满头大汗
iue	湔
iuf	混凝土
iug	泣
iuh	 
iui	河北省
iuj	涧
iuk	涪
iul	没意思
ium	潎
iun	水产局
iuo	水产业
iup	滋补
iuq	注意解决
iur	当前的
ius	河北梆子
iut	ㄅ
iuu	海关总署
iuv	淁
iuw	溢
iux	滋
iuy	漳州
iva	当世
ivb	当阳
ivc	溉
ivd	当成
ive	当月
ivf	当
ivg	汝
ivh	濜
ivi	渌
ivj	当时
ivk	沼
ivl	淄
ivm	津贴
ivn	氿
ivo	染料
ivp	浸
ivq	当然
ivr	当年
ivs	染
ivt	当选
ivu	当前
ivv	当即
ivw	梁
ivx	 
ivy	涩
iwa	当今世界
iwb	沧
iwc	没
iwd	没有
iwe	脊
iwf	浍
iwg	涂
iwh	浟
iwi	沿海
iwj	当今时代
iwk	沿
iwl	 
iwm	沿岸
iwn	㲹
iwo	濮
iwp	当今社会
iwq	没错
iwr	滏
iws	脊柱
iwt	没什么
iwu	氼
iwv	汾
iww	浴
iwx	沦
iwy	淮
ixa	消费基金
ixb	渳
ixc	泓
ixd	 
ixe	沸腾
ixf	消费者
ixg	流线型
ixh	沸点
ixi	消费水平
ixj	沸
ixk	消费品
ixl	党纪国法
ixm	涨幅
ixn	党组书记
ixo	 
ixp	 
ixq	滞纳金
ixr	 
ixs	常绿植物
ixt	涨
ixu	溺
ixv	 
ixw	潍
ixx	党组织
ixy	消费市场
iya	浪花
iyb	洲际
iyc	流
iyd	流感
iye	兴高采烈
iyf	流动
iyg	注
iyh	汴
iyi	浪潮
iyj	济
iyk	淳
iyl	澶
iym	注册
iyn	沪
iyo	湾
iyp	游客
iyq	注销
iyr	漓
iys	洗衣机
iyt	洲
iyu	滴
iyv	浪
iyw	液
iyx	泫
iyy	汶
jaa	蠂
jab	师范院校
jac	 
jad	蟒
jae	暴力
jaf	蚶
jag	虹
jah	蚜
jai	暴涨
jaj	蜡
jak	蜮
jal	蠛
jam	蟥
jan	蝶
jao	蜡烛
jap	蝾
jaq	曔
jar	显著提高
jas	最基本的
jat	晓
jau	 
jav	暴怒
jaw	暴
jax	 
jay	星期六
jba	电子工业
jbb	电子出版
jbc	最
jbd	最大
jbe	临阵脱逃
jbf	㫗
jbg	虸
jbh	㫞
jbi	最小
jbj	最早
jbk	电子器件
jbl	蜢
jbm	电子邮件
jbn	虵
jbo	临阵磨枪
jbp	最初
jbq	最多
jbr	最近
jbs	 
jbt	最长
jbu	最新
jbv	最好
jbw	最佳
jbx	最终
jby	最高
jca	昪
jcb	 
jcc	蝃
jcd	坚硬
jce	肾
jcf	坚
jcg	蚂
jch	 
jci	 
jcj	紧紧
jck	紧跟
jcl	坚固
jcm	贤
jcn	蚆
jco	 
jcp	紧密
jcq	紧急
jcr	坚持
jcs	紧要
jct	蛑
jcu	竖
jcv	 
jcw	坚信
jcx	紧
jcy	 
jda	景泰蓝
jdb	最大限度地
jdc	蛂
jdd	是否有可能
jde	蝴
jdf	晨
jdg	蛄
jdh	蚌
jdi	晨光
jdj	是不是
jdk	 
jdl	 
jdm	暊
jdn	晟
jdo	 
jdp	 
jdq	 
jdr	螈
jds	是不可能的
jdt	是否符合
jdu	旲
jdv	 
jdw	蝽
jdx	昽
jdy	明确方向
jea	电加工
jeb	蜉
jec	 
jed	明确
jee	明月
jef	冐
jeg	明
jeh	螋
jei	暖流
jej	明显
jek	日用品
jel	盟
jem	电力网
jen	明快
jeo	电脑应用
jep	暧
jeq	明镜
jer	明年
jes	电力机车
jet	㫑
jeu	明净
jev	明媚
jew	电脑公司
jex	明细
jey	电脑市场
jfa	时期
jfb	时限
jfc	野
jfd	里
jfe	里边
jff	蛙
jfg	时速
jfh	旰
jfi	昧
jfj	早
jfk	蟛
jfl	旱田
jfm	蝻
jfn	早已
jfo	黒
jfp	时空
jfq	时钟
jfr	时报
jfs	时机
jft	暑
jfu	时间
jfv	果真如此
jfw	蚨
jfx	临场经验
jfy	时
jga	师范
jgb	量子
jgc	蛭
jgd	昊
jge	晴
jgf	旦
jgg	旺
jgh	题
jgi	蛷
jgj	量
jgk	晤
jgl	最惠国待遇
jgm	师
jgn	 
jgo	题库
jgp	题写
jgq	题名
jgr	昨天的
jgs	题材
jgt	师生
jgu	蛱
jgv	蛵
jgw	师傅
jgx	昨天结束
jgy	题词
jha	监督工作
jhb	冒险
jhc	畅通
jhd	坚贞不屈
jhe	勖
jhf	冒
jhg	朄
jhh	刂
jhi	畅游
jhj	晚些时候
jhk	申
jhl	 
jhm	＃
jhn	虫
jho	冒烟
jhp	虫害
jhq	畅销
jhr	申报
jhs	监督机构
jht	监督管理
jhu	冒着
jhv	 
jhw	冒领
jhx	明目张胆
jhy	虲
jia	日常工作
jib	 
jic	鉴赏能力
jid	最深厚的
jie	蛸
jif	晃动
jig	晃
jih	 
jii	 
jij	暴涨暴跌
jik	 
jil	 
jim	㫾
jin	 
jio	日光灯
jip	螳
jiq	 
jir	最小的
jis	 
jit	日常生活
jiu	临渊羡鱼
jiv	 
jiw	旱涝保收
jix	 
jiy	最深刻
jja	曝
jjb	日子
jjc	临时观点
jjd	明显成效
jje	日用
jjf	昌
jjg	昍
jjh	星星点点
jji	日常
jjj	晶
jjk	日中
jjl	紧紧围绕
jjm	日内
jjn	明显改善
jjo	照明灯
jjp	星星之火
jjq	蝎
jjr	明显的
jjs	蜾
jjt	日程
jju	日前
jjv	明显好转
jjw	晶体
jjx	影影绰绰
jjy	䖵
jka	 
jkb	 
jkc	鉴别能力
jkd	 
jke	影响力
jkf	 
jkg	蜈
jkh	蚛
jki	暗中活动
jkj	蝇
jkk	暺
jkl	 
jkm	蜗
jkn	 
jko	 
jkp	 
jkq	㫛
jkr	鉴别手段
jks	影响极坏
jkt	影响很大
jku	 
jkv	暴跳如雷
jkw	 
jkx	 
jky	鉴别方法
jla	蛊惑
jlb	 
jlc	曼
jld	坚固耐用
jle	蝟
jlf	蛊
jlg	蝈
jlh	蛼
jli	曙光
jlj	 
jlk	蛔
jll	蠝
jlm	 
jln	 
jlo	 
jlp	 
jlq	蠋
jlr	螹
jls	星罗棋布
jlt	蜠
jlu	 
jlv	 
jlw	曼谷
jlx	螺
jly	是因为
jma	蛐
jmb	遇险
jmc	遇难
jmd	映
jme	螖
jmf	蚺
jmg	蚰
jmh	愚
jmi	 
jmj	旵
jmk	 
jml	 
jmm	遇见
jmn	 
jmo	 
jmp	映衬
jmq	蚬
jmr	帅气
jms	帅哥
jmt	映射
jmu	蝄
jmv	 
jmw	蚋
jmx	 
jmy	蛽
jna	电工
jnb	电子
jnc	电台
jnd	电压
jne	电脑
jnf	电动
jng	蛡
jnh	暇
jni	电源
jnj	电影
jnk	电路
jnl	电车
jnm	电网
jnn	虬
jno	电灯
jnp	遢
jnq	电解
jnr	电气
jns	电机
jnt	昵称
jnu	电站
jnv	电
jnw	曜
jnx	昵
jny	电话
joa	显著
job	显出
joc	昿
jod	 
joe	 
jof	显示
jog	显
joh	显眼
joi	最广泛
joj	易燃易爆
jok	 
jol	 
jom	 
jon	电业局
joo	晱
jop	 
joq	显然
jor	果断措施
jos	䗫
jot	旷
jou	炅
jov	蝼
jow	 
jox	 
joy	炚
jpa	电视节目
jpb	紧密联系
jpc	电视台
jpd	坚定不移地
jpe	 
jpf	坚定地
jpg	暄
jph	电视频道
jpi	电视小品
jpj	螟
jpk	最宝贵的
jpl	晕
jpm	坚守岗位
jpn	电视剧
jpo	电视广告
jpp	 
jpq	蜿
jpr	坚实的
jps	电视机
jpt	鉴定委员会
jpu	监察部
jpv	晏
jpw	鉴定会
jpx	蛇
jpy	电视讲话
jqa	晚期
jqb	昂
jqc	紧急通知
jqd	蟾
jqe	易用
jqf	易地
jqg	易于
jqh	晚上
jqi	晁
jqj	明争暗斗
jqk	晚
jql	蜔
jqm	日久见人心
jqn	易懂
jqo	易燃
jqp	紧锣密鼓
jqq	晚饭
jqr	易
jqs	冒名顶替
jqt	昴
jqu	昀
jqv	紧急召开
jqw	歇
jqx	 
jqy	晚熟
jra	 
jrb	蝬
jrc	最后通牒
jrd	坚持不懈
jre	最后胜利
jrf	坚持真理
jrg	蝗
jrh	昕
jri	蛛
jrj	 
jrk	 
jrl	坚持四项基本原则
jrm	㫼
jrn	紧迫性
jro	 
jrp	坚持实行
jrq	螝
jrr	最后指出
jrs	坚持标准
jrt	蜱
jru	紧接着
jrv	 
jrw	电气化
jrx	最后强调
jry	曒
jsa	 
jsb	果子
jsc	 
jsd	颗
jse	褁
jsf	螵
jsg	晒
jsh	虰
jsi	果
jsj	明枪暗箭
jsk	蚵
jsl	果园
jsm	 
jsn	果敢
jso	果断
jsp	果实
jsq	夥
jsr	晰
jss	果树
jst	㪙
jsu	杲
jsv	 
jsw	显要位置
jsx	归根结底
jsy	蚞
jta	星期
jtb	星际
jtc	暗箭难防
jtd	蜂
jte	日积月累
jtf	蚝
jtg	星
jth	昨
jti	监测
jtj	蝮
jtk	鉴别
jtl	临界
jtm	晌
jtn	虼
jto	蟠
jtp	鉴定
jtq	监狱
jtr	蛾
jts	最重要的
jtt	监管
jtu	蝌
jtv	蜲
jtw	星体
jtx	晦
jty	临
jua	暗藏
jub	蝉联
juc	 
jud	蜷
jue	日新月异
juf	昱
jug	曦
juh	日益频繁
jui	日益激烈的
juj	暗
juk	蜕
jul	蝉
jum	 
jun	时间性
juo	䗒
jup	日益突出
juq	蠀
jur	最新的
jus	蝤
jut	电冰箱
juu	时间差
juv	螊
juw	照单全收
jux	坚决贯彻
juy	蜕变
jva	蟳
jvb	旯
jvc	蝍
jvd	照顾
jve	照办
jvf	妟
jvg	归
jvh	照旧
jvi	照常
jvj	照明
jvk	照
jvl	归国
jvm	 
jvn	归属
jvo	照应
jvp	归宿
jvq	 
jvr	最好的
jvs	照相
jvt	旫
jvu	照章
jvv	 
jvw	归侨
jvx	归纳
jvy	照亮
jwa	蚮
jwb	冒风险
jwc	蚣
jwd	最伟大的
jwe	昣
jwf	暴风雪
jwg	蛤
jwh	最低点
jwi	㬰
jwj	蚧
jwk	㫟
jwl	 
jwm	 
jwn	虮
jwo	时代精神
jwp	 
jwq	 
jwr	时代气息
jws	 
jwt	晶体管
jwu	时代背景
jwv	昐
jww	最低价
jwx	晔
jwy	晗
jxa	紧张工作
jxb	㫐
jxc	蛛丝马迹
jxd	坚强有力
jxe	曳
jxf	䗰
jxg	最强烈的
jxh	蚓
jxi	最经济
jxj	昆明
jxk	 
jxl	 
jxm	昆山
jxn	紧张局势
jxo	 
jxp	最终实现
jxq	螺丝钉
jxr	日经指数
jxs	 
jxt	曏
jxu	紧张状况
jxv	 
jxw	昆仑
jxx	昆
jxy	归结为
jya	景区
jyb	是为了
jyc	景观
jyd	ア
jye	电话采访
jyf	申请专利
jyg	蛀
jyh	景点
jyi	あ
jyj	蛴
jyk	影
jyl	蟺
jym	电话网
jyn	蝙
jyo	影迷
jyp	影视
jyq	景象
jyr	蚁
jys	℡
jyt	昉
jyu	旻
jyv	螂
jyw	蛟
jyx	蟀
jyy	蚊
kaa	中医药
kab	中医院
kac	 
kad	嘶
kae	口若悬河
kaf	咁
kag	叿
kah	呀
kai	中医学
kaj	噶
kak	嘞
kal	喵
kam	咂
kan	呓
kao	 
kap	唠
kaq	噶尔
kar	哎
kas	呆若木鸡
kat	哓
kau	中共北京市委
kav	 
kaw	哄
kax	跨世纪
kay	嚆
kba	 
kbb	听取了
kbc	嗫
kbd	 
kbe	唨
kbf	咠
kbg	吇
kbh	叩
kbi	听取汇报
kbj	 
kbk	吼叫
kbl	 
kbm	咄
kbn	吼
kbo	吸烟
kbp	 
kbq	口出狂言
kbr	吸热
kbs	啊
kbt	 
kbu	中联部
kbv	 
kbw	 
kbx	戢
kby	吸
kca	 
kcb	邑
kcc	嗓
kcd	 
kce	嗵
kcf	 
kcg	吗
kch	 
kci	 
kcj	只能是
kck	咍
kcl	 
kcm	 
kcn	吧
kco	㘐
kcp	患难之交
kcq	吮
kcr	 
kcs	 
kct	唉
kcu	嗓门
kcv	 
kcw	唆
kcx	 
kcy	叹
kda	咗
kdb	呃
kdc	吰
kdd	听而不闻
kde	呖
kdf	喹
kdg	咕
kdh	嘎
kdi	吃不消
kdj	喱
kdk	喊叫
kdl	吴邦国
kdm	顺
kdn	顺心
kdo	咴
kdp	哒
kdq	吃大锅饭
kdr	顺手
kds	 
kdt	顺利
kdu	嘹
kdv	 
kdw	唪
kdx	咙
kdy	吠
kea	哺乳期
keb	哹
kec	㖬
ked	另有
kee	另加
kef	肙
keg	咀
keh	嗖
kei	口服液
kej	别
kek	咖
kel	嚼
kem	 
ken	口服心服
keo	哺乳类
kep	嗳
keq	鹃
ker	另
kes	别样
ket	叻
keu	 
kev	哸
kew	别人
kex	嗘
key	别说
kfa	喷
kfb	叶子
kfc	吱
kfd	嚅
kfe	 
kff	哇
kfg	吐
kfh	叶
kfi	味
kfj	嘲
kfk	嘻
kfl	鄙
kfm	喃
kfn	喷发
kfo	哧
kfp	嗦
kfq	呒
kfr	中老年
kfs	中直机关
kft	嗜
kfu	味道
kfv	嗜好
kfw	呋
kfx	 
kfy	嘲讽
kga	咞
kgb	吨
kgc	唯一能够
kgd	吴
kge	哺
kgf	呈
kgg	㕵
kgh	吓
kgi	中下游
kgj	哽
kgk	嗽
kgl	吃一堑长一智
kgm	嘈
kgn	号
kgo	哑
kgp	逞
kgq	咧
kgr	唯一的
kgs	吴桥
kgt	唛
kgu	另一部分
kgv	号召
kgw	吨位
kgx	咦
kgy	另一方面
kha	距
khb	蹑
khc	踊
khd	跨
khe	踩
khf	践
khg	贵
khh	趾
khi	踏
khj	踢
khk	中
khl	盅
khm	蹦
khn	忠
kho	踱
khp	踪
khq	跑
khr	跌
khs	︵
kht	跃
khu	足
khv	跟
khw	趴
khx	嘴
khy	卟
kia	 
kib	 
kic	 
kid	川流不息
kie	哨
kif	中小城市
kig	咣
kih	啵
kii	中小学
kij	吃水果
kik	唢呐
kil	 
kim	唢
kin	 
kio	 
kip	嘡
kiq	 
kir	哨所
kis	吵醒
kit	吵
kiu	品学兼优
kiv	 
kiw	中小企业
kix	 
kiy	 
kja	嚗
kjb	嘬
kjc	唱戏
kjd	 
kje	喝彩
kjf	哩
kjg	呾
kjh	呻
kji	喝酒
kjj	唱
kjk	呻吟
kjl	嗢
kjm	喁
kjn	黾
kjo	 
kjp	 
kjq	喝
kjr	吃里爬外
kjs	唱歌
kjt	唱片
kju	虽
kjv	 
kjw	 
kjx	㖂
kjy	虽说
kka	噐
kkb	口子
kkc	骂
kkd	器
kke	口腔
kkf	吕
kkg	吅
kkh	串
kki	品尝
kkj	丳
kkk	品
kkl	鼍
kkm	口岸
kkn	品性
kko	口粮
kkp	器官
kkq	品名
kkr	品质
kks	器材
kkt	品种
kku	噪音
kkv	咆哮如雷
kkw	咒
kkx	嚣张
kky	口语
kla	中国共产党
klb	中国队
klc	中国通
kld	咽
kle	喟
klf	嘿
klg	喂
klh	呷
kli	中国海洋石油总公司
klj	中国电信
klk	咽喉
kll	中国软件行业协会
klm	中国内政
kln	中国民航
klo	中国烟草总公司
klp	中国社会科学院
klq	中国银行
klr	中国的
kls	中国核工业总公司
klt	中国科学院
klu	喂养
klv	中国妇女
klw	中国人
klx	中国红十字会
kly	中国文化
kma	嗣
kmb	郧
kmc	中央预算
kmd	喘
kme	勋
kmf	啁
kmg	哃
kmh	吊
kmi	中央党校
kmj	中央电视台
kmk	路由器
kml	中央国家机关
kmm	嘤
kmn	中央书记处
kmo	中央精神
kmp	中央军委
kmq	哕
kmr	中央的
kms	中央机关
kmt	中央委员会
kmu	员
kmv	 
kmw	呐
kmx	中央纪委
kmy	呗
kna	中心区
knb	忠心耿耿
knc	哪能
knd	啹
kne	 
knf	中心城市
kng	哪
knh	叫
kni	呕心沥血
knj	哪里
knk	噼
knl	中心思想
knm	唰
knn	哪怕
kno	叫座
knp	 
knq	哪儿
knr	遗憾的是
kns	 
knt	嘱
knu	跃居首位
knv	叫好
knw	哪个
knx	呢
kny	吣
koa	喥
kob	顺应了
koc	 
kod	 
koe	 
kof	 
kog	噗
koh	㖢
koi	顺应潮流
koj	 
kok	 
kol	 
kom	 
kon	 
koo	啖
kop	中庸之道
koq	噒
kor	 
kos	嘛
kot	 
kou	 
kov	喽
kow	 
kox	 
koy	咪
kpa	噻
kpb	 
kpc	 
kpd	喧宾夺主
kpe	哝
kpf	唍
kpg	喧
kph	 
kpi	 
kpj	 
kpk	喧嚣
kpl	喗
kpm	 
kpn	嘧
kpo	 
kpp	 
kpq	啘
kpr	 
kps	咛
kpt	喀
kpu	中宣部
kpv	咹
kpw	嚓
kpx	咜
kpy	 
kqa	呧
kqb	兄
kqc	中外观众
kqd	另外还有
kqe	唃
kqf	唤起
kqg	噜
kqh	 
kqi	哈尔滨
kqj	咰
kqk	吹嘘
kql	 
kqm	唤
kqn	呜
kqo	 
kqp	吃饱穿暖
kqq	哆
kqr	吻
kqs	唤醒
kqt	吐鲁番
kqu	兄弟
kqv	兄妹
kqw	吹
kqx	跃然纸上
kqy	鸣
kra	唣
krb	听取
krc	呱
krd	唏
kre	哌
krf	品质超群
krg	㕷
krh	听
kri	史
krj	 
krk	蹑手蹑脚
krl	 
krm	史册
krn	史书
kro	史料
krp	史实
krq	啲
krr	啪
krs	唾手可得
krt	啤
kru	啦
krv	 
krw	听众
krx	喞
kry	听说
ksa	中西医结合
ksb	 
ksc	只要能
ksd	喖
kse	 
ksf	嘌
ksg	哂
ksh	叮
ksi	呆滞
ksj	喳
ksk	呵
ksl	㘄
ksm	呆帐
ksn	 
kso	 
ksp	中枢神经
ksq	 
ksr	唽
kss	噤
kst	 
ksu	呆
ksv	喓
ksw	唻
ksx	 
ksy	㕲
kta	噬
ktb	中科院
ktc	另行通知
ktd	哭笑不得
kte	吃力
ktf	唾
ktg	跻身于
kth	咱
kti	呼和浩特
ktj	吃紧
ktk	咯
ktl	囖
ktm	响
ktn	吃
kto	啾
ktp	顺利完成
ktq	叶利钦
ktr	哦
kts	呼机
ktt	响彻
ktu	呼
ktv	唩
ktw	咱们
ktx	啼笑皆非
kty	呚
kua	 
kub	嗍
kuc	 
kud	中美三个联合公报
kue	㗴
kuf	呌
kug	嗟
kuh	吖
kui	中美洲
kuj	噫
kuk	哾
kul	噌
kum	 
kun	中间层
kuo	 
kup	口头禅
kuq	嚪
kur	 
kus	中关村
kut	兄弟般
kuu	中美关系
kuv	唼
kuw	嗌
kux	嗞
kuy	品头论足
kva	噚
kvb	 
kvc	唧
kvd	嗜好成癖
kve	哏
kvf	㖊
kvg	㖀
kvh	嚍
kvi	啸
kvj	 
kvk	嗈
kvl	 
kvm	 
kvn	㕤
kvo	嘨
kvp	唚
kvq	 
kvr	叧
kvs	 
kvt	叨
kvu	 
kvv	 
kvw	䬭
kvx	 
kvy	 
kwa	遗传工程
kwb	呛
kwc	嗡
kwd	只有
kwe	只用
kwf	啥
kwg	哈
kwh	只占
kwi	遗传学
kwj	只是
kwk	哈哈
kwl	只因
kwm	只见
kwn	叽
kwo	 
kwp	哈密
kwq	中华儿女
kwr	嗲
kws	咻
kwt	只得
kwu	只
kwv	吩
kww	唑
kwx	哗
kwy	叭
kxa	 
kxb	吸引了
kxc	 
kxd	 
kxe	呦
kxf	 
kxg	喙
kxh	吲
kxi	中级法院
kxj	咈
kxk	中继器
kxl	 
kxm	㖰
kxn	叱
kxo	 
kxp	 
kxq	哟
kxr	嚣张气焰
kxs	 
kxt	中纪委
kxu	中组部
kxv	 
kxw	吸引人
kxx	哔
kxy	吆
kya	咬牙
kyb	唁函
kyc	唷
kyd	 
kye	 
kyf	忠诚老实
kyg	唁
kyh	 
kyi	贵州省
kyj	哜
kyk	嚷
kyl	中文输入
kym	中文网站
kyn	咳
kyo	 
kyp	 
kyq	唱主角
kyr	趾高气扬
kys	中高档
kyt	㕫
kyu	啼
kyv	啷
kyw	吭
kyx	中高级
kyy	呅
laa	轼
lab	斩草除根
lac	 
lad	䡳
lae	 
laf	黔东南
lag	国共两党
lah	轞
lai	罪孽深重
laj	羃
lak	㘟
lal	䡸
lam	置若罔闻
lan	 
lao	轻工业
lap	国营农场
laq	固若金汤
lar	羁押
las	 
lat	 
lau	轻工部
lav	 
law	国营企业
lax	羁绊
lay	国营商业
lba	国防工业
lbb	国际联网
lbc	男子双打
lbd	囝
lbe	国际舆论
lbf	国际地位
lbg	国际互联网
lbh	国际上
lbi	国际水平
lbj	国际影响
lbk	 
lbl	国际国内
lbm	国际周
lbn	辄
lbo	团队精神
lbp	国际社会
lbq	国际贸易
lbr	国际舞台
lbs	国际标准
lbt	国际先进水平
lbu	国际竞争
lbv	国防建设
lbw	墼
lbx	国际组织
lby	国际市场
lca	轻
lcb	轻取
lcc	轰
lcd	Α
lce	㔥
lcf	轰动
lcg	轻型
lch	 
lci	囜
lcj	轻易
lck	轰鸣
lcl	轻轨
lcm	轻则
lcn	罗马尼亚
lco	轰炸
lcp	轻视
lcq	㽙
lcr	 
lcs	轻松
lct	困难重重
lcu	 
lcv	 
lcw	轻便
lcx	轻纺
lcy	困难户
lda	因其
ldb	轭
ldc	軷
ldd	固
lde	囿
ldf	罟
ldg	轱
ldh	罘
ldi	因
ldj	罨
ldk	 
ldl	 
ldm	恩赐
ldn	恩
ldo	罪有应得
ldp	固定
ldq	固然
ldr	较大的
lds	畸
ldt	畴
ldu	国有资产
ldv	 
ldw	辏
ldx	国有经济
ldy	軑
lea	男式
leb	男子
lec	男双
led	男朋友
lee	㘞
lef	胃
leg	䢁
leh	 
lei	 
lej	 
lek	胃口
lel	男团
lem	 
len	男性
leo	 
lep	 
leq	男儿
ler	男
les	 
let	㽖
leu	男单
lev	嬲
lew	男人
lex	 
ley	男方
lfa	园区
lfb	罢了
lfc	罢
lfd	转达
lfe	转用
lff	畦
lfg	置于
lfh	轩
lfi	団
lfj	䍐
lfk	辕
lfl	默默
lfm	罱
lfn	转
lfo	黑
lfp	黑客
lfq	园
lfr	转换
lfs	围棋
lft	署
lfu	圉
lfv	围剿
lfw	转化
lfx	围绕
lfy	转变
lga	国营
lgb	囤
lgc	轾
lgd	囯
lge	辅
lgf	国土
lgg	軖
lgh	罡
lgi	车流
lgj	畀
lgk	辐
lgl	车辆
lgm	辆
lgn	车
lgo	国庆
lgp	国家
lgq	国外
lgr	国手
lgs	国歌
lgt	辐射
lgu	国产
lgv	輺
lgw	国会
lgx	 
lgy	国
lha	䡾
lhb	 
lhc	四通
lhd	罪
lhe	四月
lhf	四十
lhg	四万
lhh	 
lhi	四海
lhj	罩
lhk	㐃
lhl	 
lhm	四周
lhn	甲
lho	 
lhp	罪案
lhq	罪犯
lhr	 
lhs	甲板
lht	四处
lhu	罩着
lhv	 
lhw	四化
lhx	甲级
lhy	四方
lia	 
lib	 
lic	车水马龙
lid	圆满成功
lie	輎
lif	罚没款
lig	輄
lih	 
lii	囦
lij	㘤
lik	 
lil	 
lim	 
lin	〇
lio	 
lip	圆满完成
liq	圆满解决
lir	因小失大
lis	固沙林
lit	输油管
liu	眔
liv	 
liw	䳴
lix	圆满结束
liy	轻举妄动
lja	罼
ljb	 
ljc	 
ljd	 
lje	 
ljf	 
ljg	连日来
ljh	 
lji	 
ljj	 
ljk	 
ljl	圆明园
ljm	 
ljn	 
ljo	 
ljp	回归祖国
ljq	輵
ljr	 
ljs	輠
ljt	 
lju	因果关系
ljv	 
ljw	 
ljx	辊
ljy	 
lka	回落
lkb	辑
lkc	 
lkd	回
lke	罥
lkf	軎
lkg	回到
lkh	甽
lki	四川省
lkj	回归
lkk	回路
lkl	回国
lkm	圆
lkn	回收
lko	回应
lkp	回家
lkq	軦
lkr	回报
lks	圆柱
lkt	回答
lku	回头
lkv	 
lkw	轵
lkx	回乡
lky	回族
lla	 
llb	田联
llc	 
lld	䍛
lle	 
llf	畕
llg	圜
llh	䡛
lli	 
llj	田野
llk	㘡
lll	田
llm	 
lln	逻辑性
llo	 
llp	轋
llq	 
llr	逻辑推理
lls	田林
llt	田径
llu	田间
llv	男男女女
llw	田园风光
llx	 
lly	转轨变型
lma	 
lmb	轴承
lmc	 
lmd	Α
lme	 
lmf	男同志
lmg	轴
lmh	軕
lmi	 
lmj	 
lmk	 
lml	 
lmm	 
lmn	轴心
lmo	 
lmp	 
lmq	国内外
lmr	 
lms	 
lmt	国内先进水平
lmu	辋
lmv	 
lmw	軜
lmx	α
lmy	国内市场
lna	辗
lnb	轏
lnc	罹难
lnd	国民大会
lne	 
lnf	思考
lng	翈
lnh	思虑
lni	国民党
lnj	思量
lnk	思路
lnl	辗转
lnm	 
lnn	轧
lno	 
lnp	图书室
lnq	图书馆
lnr	轧制
lns	思想
lnt	国民生产总值
lnu	思
lnv	回忆录
lnw	罹
lnx	国民经济
lny	国民议会
loa	国庆节
lob	 
loc	 
lod	软磨硬泡
loe	 
lof	转业干部
log	轐
loh	黑灯瞎火
loi	 
loj	国庆日
lok	 
lol	 
lom	 
lon	辘
loo	 
lop	转业军人
loq	辚
lor	 
los	 
lot	 
lou	䍘
lov	 
low	 
lox	 
loy	 
lpa	辖区
lpb	国家队
lpc	连通
lpd	辖
lpe	连胜
lpf	国家教委
lpg	国家环保局
lph	輨
lpi	国家法
lpj	连日
lpk	连
lpl	连连
lpm	国家财政
lpn	国家民委
lpo	置之度外
lpp	国家安全
lpq	畹
lpr	连接
lps	国家标准
lpt	国家科委
lpu	固定资产
lpv	国家建设
lpw	国家体委
lpx	连续
lpy	国家计委
lqa	软卧
lqb	 
lqc	罗马
lqd	轩然大波
lqe	輡
lqf	罗干
lqg	罗列
lqh	 
lqi	罗汉
lqj	蜀
lqk	軥
lql	逻辑
lqm	罗山
lqn	軳
lqo	连锁店
lqp	逻
lqq	罗甸
lqr	囫
lqs	 
lqt	软盘
lqu	罗
lqv	 
lqw	软
lqx	软弱
lqy	鸭
lra	团的工作
lrb	䍟
lrc	畈
lrd	暂不
lre	暂且
lrf	堑
lrg	轶事
lrh	斩
lri	轻描淡写
lrj	暂
lrk	蹔
lrl	轻手轻脚
lrm	圆舞曲
lrn	固执己见
lro	 
lrp	罪魁祸首
lrq	錾
lrr	㨻
lrs	椠
lrt	暂行
lru	转折关头
lrv	㜞
lrw	轶
lrx	转换经营机制
lry	 
lsa	困惑
lsb	 
lsc	困难
lsd	思想感情
lse	 
lsf	困境
lsg	思想政治工作
lsh	町
lsi	困
lsj	甼
lsk	轲
lsl	 
lsm	 
lsn	 
lso	 
lsp	思想家
lsq	思想包袱
lsr	困扰
lss	墨西哥
lst	 
lsu	䍒
lsv	思想建设
lsw	思想作风
lsx	思想统一
lsy	思想认识
lta	 
ltb	国务院
ltc	辐射能
ltd	轿
lte	略加
ltf	暂行规定
ltg	图形
lth	䡻
lti	囷
ltj	图景
ltk	略
ltl	轿车
ltm	因特网
ltn	轹
lto	四季度
ltp	图案
ltq	图象
ltr	男选手
lts	图板
ltt	图片
ltu	图
ltv	恩重如山
ltw	图像
ltx	图纸
lty	畋
lua	軿
lub	圈子
luc	 
lud	圈
lue	䡵
luf	 
lug	畔
luh	轻装上阵
lui	 
luj	疃
luk	回头路
lul	罾
lum	 
lun	 
luo	 
lup	 
luq	 
lur	図
lus	思前想后
lut	田间管理
luu	轻装前进
luv	男尊女卑
luw	国产化
lux	罤
luy	车间主任
lva	 
lvb	男女队
lvc	男女双方
lvd	囡
lve	 
lvf	㚻
lvg	男女平等
lvh	 
lvi	 
lvj	罺
lvk	轺
lvl	辎
lvm	 
lvn	轨
lvo	 
lvp	遱
lvq	 
lvr	 
lvs	 
lvt	氀
lvu	轨道
lvv	 
lvw	鷜
lvx	 
lvy	轫
lwa	轮式
lwb	输出
lwc	轮台
lwd	界面
lwe	轸
lwf	囶
lwg	输
lwh	 
lwi	囚
lwj	界
lwk	软件中心
lwl	轮回
lwm	 
lwn	䡄
lwo	软件业
lwp	界定
lwq	软件包
lwr	软件技术
lws	轮椅
lwt	输入
lwu	软件产品
lwv	四化建设
lww	软件企业
lwx	轮
lwy	㽗
lxa	 
lxb	甲级队
lxc	思维能力
lxd	团结奋斗
lxe	累加
lxf	团结协作
lxg	团结一致
lxh	羄
lxi	累
lxj	 
lxk	羂
lxl	累累
lxm	 
lxn	连续性
lxo	 
lxp	 
lxq	墨绿色
lxr	 
lxs	 
lxt	累积
lxu	轻纺产品
lxv	 
lxw	毗邻
lxx	毗
lxy	累计
lya	 
lyb	转变职能
lyc	辙
lyd	圁
lye	畩
lyf	詈
lyg	略高于
lyh	 
lyi	较少
lyj	罚
lyk	輬
lyl	较轻
lym	 
lyn	较快
lyo	 
lyp	较之
lyq	较多
lyr	较近
lys	 
lyt	较长
lyu	较差
lyv	较好
lyw	较
lyx	较强
lyy	较高
maa	典范
mab	曲子
mac	 
mad	曲
mae	 
maf	嵌
mag	屸
mah	岈
mai	岽
maj	嶱
mak	巈
mal	 
mam	崂山
man	周期性
mao	 
map	嵘
maq	曲解
mar	岖
mas	 
mat	嵌入
mau	曲靖
mav	 
maw	典
max	曲线
may	戝
mba	 
mbb	㕀
mbc	 
mbd	邮码
mbe	 
mbf	 
mbg	㞨
mbh	邮
mbi	崡
mbj	邮电
mbk	邮路
mbl	 
mbm	邮购
mbn	貤
mbo	 
mbp	邮寄
mbq	邮包
mbr	㞧
mbs	邮票
mbt	屷
mbu	邮资
mbv	 
mbw	邮件
mbx	邮编
mby	岌
mca	峅
mcb	岜
mcc	嵾
mcd	㟥
mce	 
mcf	 
mcg	峄
mch	 
mci	禸
mcj	 
mck	贻
mcl	 
mcm	峻岭
mcn	 
mco	 
mcp	 
mcq	 
mcr	 
mcs	刚柔相济
mct	 
mcu	 
mcv	 
mcw	峻
mcx	 
mcy	贻误
mda	巁
mdb	内在联系
mdc	 
mdd	岩石
mde	贿
mdf	岩
mdg	岵
mdh	酆
mdi	央
mdj	崦
mdk	 
mdl	盎
mdm	颛
mdn	岩层
mdo	炭
mdp	赈灾
mdq	鸯
mdr	屵
mds	崎
mdt	央行
mdu	岩浆
mdv	 
mdw	骨灰盒
mdx	賎
mdy	网页设计
mea	嶾
meb	骨子
mec	 
med	髓
mee	崩
mef	骨
meg	岄
meh	骳
mei	崩溃
mej	髁
mek	䯣
mel	髑
mem	骨髓
men	髎
meo	髅
mep	髋
meq	鹘
mer	屴
mes	骵
met	骼
meu	骨头
mev	骩
mew	骰
mex	嵠
mey	骸
mfa	周期
mfb	 
mfc	岐
mfd	冉
mfe	财力
mff	峙
mfg	财政
mfh	赋
mfi	财源
mfj	 
mfk	雕
mfl	周围
mfm	周岁
mfn	赎
mfo	 
mfp	财富
mfq	财贸
mfr	周年
mfs	财权
mft	财
mfu	财产
mfv	 
mfw	同志们
mfx	贱
mfy	雕刻
mga	岍
mgb	败下阵来
mgc	财政预算
mgd	同感
mge	赙
mgf	同志
mgg	同一
mgh	同步
mgi	赇
mgj	同时
mgk	同
mgl	财政困难
mgm	嶆
mgn	屿
mgo	崃
mgp	财政补贴
mgq	同名
mgr	典型的
mgs	同样
mgt	同行
mgu	峡
mgv	刚开始
mgw	同一个
mgx	邮政编码
mgy	同义
mha	帷幕
mhb	帽子
mhc	网上通缉
mhd	帱
mhe	网上办公
mhf	帏
mhg	幅
mhh	帖
mhi	帩
mhj	帽
mhk	巾
mhl	帼
mhm	巾帼
mhn	冂
mho	幞
mhp	贴补
mhq	网上银行
mhr	帕
mhs	由此可见
mht	帐
mhu	幢
mhv	㠴
mhw	帆
mhx	㠲
mhy	帐户
mia	财源茂盛
mib	 
mic	 
mid	巌
mie	峭
mif	内河运输
mig	雕梁画栋
mih	 
mii	山清水秀
mij	山洪暴发
mik	丹江口
mil	 
mim	䞆
min	峭壁
mio	 
mip	贘
miq	 
mir	 
mis	 
mit	由浅入深
miu	汖
miv	崇洋媚外
miw	嵴
mix	 
miy	 
mja	同时期
mjb	同时也说明
mjc	邮电通信
mjd	则有
mje	 
mjf	㞱
mjg	同归于尽
mjh	则
mji	雕虫小技
mjj	䞎
mjk	 
mjl	 
mjm	嵎
mjn	邮电局
mjo	邮电业
mjp	同盟军
mjq	赐
mjr	 
mjs	 
mjt	见景生情
mju	邮电部
mjv	岿
mjw	同时代
mjx	崐
mjy	 
mka	 
mkb	幅员辽阔
mkc	 
mkd	冋
mke	 
mkf	 
mkg	㞻
mkh	㞲
mki	山呼海啸
mkj	 
mkk	同呼吸
mkl	 
mkm	 
mkn	 
mko	 
mkp	迥
mkq	贶
mkr	贼喊捉贼
mks	 
mkt	 
mku	㟕
mkv	 
mkw	嶉
mkx	 
mky	 
mla	 
mlb	 
mlc	 
mld	崮
mle	 
mlf	 
mlg	周恩来
mlh	岬
mli	 
mlj	周转量
mlk	峰回路转
mll	㠥
mlm	 
mln	崽
mlo	 
mlp	 
mlq	 
mlr	崭
mls	 
mlt	 
mlu	崭新
mlv	㟺
mlw	幽默风趣
mlx	 
mly	 
mma	山东
mmb	删除
mmc	 
mmd	巾帼不让须眉
mme	山脉
mmf	峀
mmg	册
mmh	屾
mmi	山水
mmj	岀
mmk	山路
mml	 
mmm	山
mmn	删改
mmo	山庄
mmp	山寨
mmq	岘
mmr	岗
mms	山西
mmt	贁
mmu	山头
mmv	婴
mmw	岗位
mmx	刚刚结束
mmy	賏
mna	岷
mnb	岂
mnc	岂能
mnd	见怪不怪
mne	购买力
mnf	崛起
mng	赎买政策
mnh	嵋
mni	内心深处
mnj	剀
mnk	㠔
mnl	见异思迁
mnm	觊
mnn	屺
mno	岂料
mnp	 
mnq	内忧外患
mnr	嶍
mns	凯歌
mnt	刚愎自用
mnu	 
mnv	囘
mnw	凯
mnx	㞾
mny	赆
moa	同业工会
mob	 
moc	 
mod	 
moe	 
mof	赃
mog	嶪
moh	 
moi	 
moj	 
mok	 
mol	 
mom	 
mon	同床异梦
moo	赕
mop	 
moq	嶙
mor	 
mos	内燃机车
mot	赃物
mou	同类产品
mov	嵝
mow	同业公会
mox	 
moy	 
mpa	贮藏
mpb	败家子
mpc	 
mpd	迪
mpe	 
mpf	崇
mpg	贮
mph	 
mpi	䢙
mpj	崇明
mpk	辿
mpl	賱
mpm	 
mpn	 
mpo	迪庆
mpp	周密安排
mpq	䝹
mpr	崇拜
mps	 
mpt	内容简介
mpu	㞫
mpv	内容如下
mpw	崆
mpx	岮
mpy	崇高
mqa	岻
mqb	见
mqc	购
mqd	赡
mqe	岁月
mqf	崟
mqg	崯
mqh	财贸战线
mqi	 
mqj	峋
mqk	岣
mql	购置
mqm	峥嵘
mqn	购买
mqo	岁数
mqp	 
mqq	见解
mqr	见报
mqs	 
mqt	峁
mqu	岁
mqv	峥
mqw	㰞
mqx	 
mqy	见效
mra	㟛
mrb	贩子
mrc	贩
mrd	崤
mre	 
mrf	网址
mrg	岶
mrh	岓
mri	冈
mrj	刚
mrk	肉制品
mrl	网罗
mrm	刚刚
mrn	网民
mro	 
mrp	周年之际
mrq	嵬
mrr	网
mrs	 
mrt	崥
mru	网站
mrv	刚好
mrw	嶊
mrx	网络
mry	 
msa	嶘
msb	 
msc	 
msd	嵿
mse	 
msf	㟽
msg	 
msh	 
msi	山西省
msj	嵖
msk	岢
msl	 
msm	 
msn	 
mso	 
msp	 
msq	内查外调
msr	同样的
mss	崊
mst	由西向东
msu	 
msv	崾
msw	崧
msx	 
msy	嵀
mta	账
mtb	䝯
mtc	同等对待
mtd	峰
mte	嵊县
mtf	败坏
mtg	貹
mth	账目
mti	同等学历
mtj	财务监督
mtk	赂
mtl	賉
mtm	巍峨
mtn	屹
mto	同行业
mtp	贬
mtq	巍然
mtr	峨
mts	财务检查
mtt	财务管理
mtu	嵊
mtv	巍
mtw	贬值
mtx	败给
mty	败
mua	朑
mub	胐
muc	内部矛盾
mud	㟡
mue	巃
muf	岦
mug	嵯
muh	 
mui	 
muj	嶂
muk	赔
mul	赠
mum	 
mun	邮资已付
muo	朥
mup	雕塑家
muq	赚钱
mur	崭新的
mus	财产权
mut	由北向南
muu	赠送
muv	赚
muw	赔偿
mux	嵫
muy	罔
mva	 
mvb	 
mvc	 
mvd	 
mve	峎
mvf	 
mvg	由始至终
mvh	 
mvi	㟤
mvj	 
mvk	岹
mvl	崰
mvm	 
mvn	 
mvo	 
mvp	 
mvq	 
mvr	屶
mvs	 
mvt	峮
mvu	 
mvv	 
mvw	 
mvx	 
mvy	见好就收
mwa	内功
mwb	内陆
mwc	内参
mwd	内在
mwe	内脏
mwf	赊
mwg	嶝
mwh	内战
mwi	内
mwj	见分晓
mwk	内中
mwl	内因
mwm	见仁见智
mwn	㞦
mwo	肉类
mwp	内容
mwq	内外
mwr	岚
mws	 
mwt	内科
mwu	㞤
mwv	岎
mww	肉
mwx	内线
mwy	岭
mxa	幽雅
mxb	 
mxc	 
mxd	 
mxe	网络服务器
mxf	同比增长
mxg	幽静
mxh	巓
mxi	幽深
mxj	网络电话
mxk	网络路由器
mxl	幽默
mxm	 
mxn	 
mxo	 
mxp	网络安全
mxq	婴幼儿
mxr	网络技术
mxs	 
mxt	嶷
mxu	网络资源
mxv	幽灵
mxw	网络信息
mxx	幽
mxy	㟂
mya	丹东
myb	丹阳
myc	见义勇为
myd	丹
mye	彤
myf	訔
myg	丹麦
myh	 
myi	 
myj	凯旋归来
myk	嵩
myl	 
mym	嵩山
myn	赅
myo	崇高精神
myp	 
myq	 
myr	崇高的敬意
mys	 
myt	见诸行动
myu	㞵
myv	崀
myw	见证人
myx	䝮
myy	㞶
naa	民警
nab	展出
nac	展台
nad	惶恐不安
nae	展
naf	展示
nag	羾
nah	异步
nai	异常
naj	异
nak	展品
nal	懵
nam	异同
nan	屉
nao	 
nap	以工补农
naq	展销
nar	怄
nas	民歌
nat	懂
nau	民间
nav	民
naw	殿
nax	民营经济
nay	慌
nba	避孕药
nbb	孱
nbc	慑
nbd	㞌
nbe	屈服
nbf	悦耳动听
nbg	敢于
nbh	邔
nbi	 
nbj	 
nbk	㥛
nbl	 
nbm	屈
nbn	忚
nbo	 
nbp	 
nbq	 
nbr	敢打
nbs	屙
nbt	敢
nbu	 
nbv	 
nbw	屈从
nbx	 
nby	敢说
nca	 
ncb	 
ncc	惙
ncd	惨
nce	怀柔县
ncf	怪
ncg	怿
nch	 
nci	㞋
ncj	司马昭之心路人皆知
nck	怡
ncl	 
ncm	惨败
ncn	惨剧
nco	 
ncp	惨案
ncq	 
ncr	避难所
ncs	壁垒森严
nct	惨重
ncu	惨痛
ncv	㞎
ncw	悛
ncx	 
ncy	避难就易
nda	惰
ndb	剧院
ndc	怀柔
ndd	居
nde	懮
ndf	发达地区
ndg	怙
ndh	怀
ndi	 
ndj	剧
ndk	居中
ndl	发达国家
ndm	怖
ndn	忧
ndo	恢
ndp	居室
ndq	居然
ndr	怀抱
nds	必不可少
ndt	恢复
ndu	怀着
ndv	惨不忍睹
ndw	居住
ndx	怀疑
ndy	忕
nea	民用工业
neb	以貌取人
nec	 
ned	尽力而为
nee	恊
nef	民办教师
neg	屈服于
neh	必须具有
nei	必须注意
nej	必须坚持
nek	心服口服
nel	 
nem	收受贿赂
nen	民用飞机
neo	 
nep	心腹之患
neq	心胸狭窄
ner	必须按照
nes	㥒
net	忇
neu	心脏病
nev	 
new	民办公助
nex	必须强调
ney	必须认识到
nfa	愤
nfb	展示了
nfc	层
nfd	懦
nfe	 
nff	恃
nfg	迅速
nfh	慎
nfi	慰
nfj	导师
nfk	卂
nfl	导轨
nfm	局域网
nfn	层层
nfo	懗
nfp	迅
nfq	怃
nfr	屠杀
nfs	发动机
nft	屠
nfu	导
nfv	愤怒
nfw	展示会
nfx	导弹
nfy	忖
nga	情节
ngb	那
ngc	屋
ngd	刁
nge	情
ngf	䍿
ngg	忹
ngh	怔
ngi	司法
ngj	恒
ngk	司
ngl	情思
ngm	那曲
ngn	迅速发展
ngo	 
ngp	恒定
ngq	那儿
ngr	情报
ngs	那样
ngt	那么
ngu	怦
ngv	恰到好处
ngw	那个
ngx	愫
ngy	发表讲话
nha	收获
nhb	收取
nhc	疏通
nhd	眉
nhe	胥
nhf	丑
nhg	收到
nhh	眉目
nhi	疋
nhj	蛋
nhk	丩
nhl	收回
nhm	收购
nhn	收发
nho	蛋糕
nhp	收割
nhq	鹛
nhr	以上的
nhs	疏松
nht	收
nhu	收益
nhv	收录
nhw	惧
nhx	收费
nhy	疏
nia	 
nib	 
nic	惊涛骇浪
nid	尽兴而归
nie	屑
nif	发源地
nig	恍
nih	眉清目秀
nii	尿
nij	䎓
nik	 
nil	迟浩田
nim	惝
nin	悄悄
nio	 
nip	书法家
niq	悄然
nir	悩
nis	司法机关
nit	犀
niu	司法部
niv	 
niw	 
nix	惨淡经营
niy	 
nja	懪
njb	 
njc	悭
njd	发电厂
nje	避暑胜地
njf	悍
njg	怛
njh	心明眼亮
nji	愰
njj	发电量
njk	展览中心
njl	慢
njm	避暑山庄
njn	慢性
njo	 
njp	发明家
njq	惕
njr	那时的
njs	发电机
njt	惺
nju	发明奖
njv	 
njw	展览会
njx	惃
njy	憬
nka	郼
nkb	避孕
nkc	悒
nkd	心中有数
nke	臂膀
nkf	吢
nkg	避开
nkh	忡
nki	忙中添乱
nkj	避暑
nkk	愕
nkl	 
nkm	异口同声
nkn	尽忠尽职
nko	 
nkp	 
nkq	避免
nkr	壁挂
nks	 
nkt	♂
nku	壁
nkv	譬如
nkw	避风
nkx	 
nky	以史为鉴
nla	翼
nlb	 
nlc	 
nld	乪
nle	㥜
nlf	 
nlg	怬
nlh	 
nli	 
nlj	 
nlk	恛
nll	 
nlm	 
nln	心连心
nlo	 
nlp	慩
nlq	 
nlr	惭
nls	悃
nlt	 
nlu	快车道
nlv	慺
nlw	异国风光
nlx	㦬
nly	愣
nma	憹
nmb	 
nmc	 
nmd	届
nme	愲
nmf	惆
nmg	恫
nmh	刷
nmi	屃
nmj	恻
nmk	 
nml	 
nmm	异曲同工
nmn	恺
nmo	 
nmp	必由之路
nmq	 
nmr	情同手足
nms	 
nmt	 
nmu	惘
nmv	 
nmw	收购价格
nmx	 
nmy	收购计划
nna	巽
nnb	发展了
nnc	 
nnd	局面
nne	书架
nnf	发展趋势
nng	己
nnh	书
nni	书法
nnj	发展是硬道理
nnk	局
nnl	乙
nnm	心惊肉跳
nnn	忆
nno	书店
nnp	书写
nnq	书名
nnr	局势
nns	发展机遇
nnt	局长
nnu	忌
nnv	乜
nnw	快
nnx	怩
nny	羽
noa	懭
nob	 
noc	 
nod	已类左框心尸羽
noe	 
nof	导火索
nog	屡遭
noh	惦
noi	屎
noj	 
nok	 
nol	 
nom	 
non	屡屡
noo	惔
nop	 
noq	 
nor	 
nos	懡
not	 
nou	屡次
nov	慷
now	惦念
nox	导火线
noy	惦记
npa	 
npb	 
npc	慎之又慎
npd	心神不定
npe	迉
npf	发祥地
npg	发家致富
nph	悺
npi	 
npj	悔之晚矣
npk	 
npl	恽
npm	司空见惯
npn	惋惜
npo	 
npp	异军突起
npq	惋
npr	 
nps	以礼相待
npt	恨之入骨
npu	 
npv	 
npw	心宽体胖
npx	 
npy	收视率
nqa	忯
nqb	
nqc	懈怠
nqd	恍然大悟
nqe	懈
nqf	必然趋势
nqg	惍
nqh	 
nqi	民怨沸腾
nqj	恂
nqk	展销中心
nql	 
nqm	愌
nqn	迅猛发展
nqo	心急火燎
nqp	必争之地
nqq	恀
nqr	惚
nqs	 
nqt	以逸待劳
nqu	心猿意马
nqv	心急如焚
nqw	必然会
nqx	必然结果
nqy	懰
nra	惶惑
nrb	发挥了
nrc	㤆
nrd	发扬成绩
nre	 
nrf	翫
nrg	怕
nrh	忻
nri	发扬光大
nrj	发热量
nrk	飞扬跋扈
nrl	 
nrm	情报网
nrn	忾
nro	 
nrp	 
nrq	愧
nrr	蛋白质
nrs	屈指可数
nrt	发挥自身优势
nru	愧疚
nrv	 
nrw	发挥作用
nrx	㦡
nry	忻州
nsa	必要劳动
nsb	 
nsc	尽可能
nsd	屡禁不止
nse	 
nsf	飞机场
nsg	恓
nsh	忊
nsi	杘
nsj	憛
nsk	 
nsl	 
nsm	 
nsn	必要性
nso	憟
nsp	 
nsq	 
nsr	必要的
nss	憷
nst	必要条件
nsu	 
nsv	 
nsw	 
nsx	 
nsy	怵
nta	怅
ntb	悸
ntc	发
ntd	恬
nte	必
ntf	尾
ntg	性
nth	屣
nti	发光
ntj	虱
ntk	属
ntl	恤
ntm	懊
ntn	发展
nto	愀
ntp	必定
ntq	必然
ntr	发挥
nts	必要
ntt	履
ntu	改善
ntv	改建
ntw	发作
ntx	悔
nty	改
nua	屏
nub	改善了
nuc	必将对
nud	习
nue	飞腾
nuf	翌
nug	翋
nuh	局部战争
nui	飞
nuj	憧
nuk	悦
nul	憎
num	 
nun	习惯
nuo	 
nup	买家
nuq	飞鸟
nur	飞扬
nus	飞机
nut	飞行
nuu	飞翔
nuv	慊
nuw	习俗
nux	悌
nuy	悯
nva	恰如其分
nvb	 
nvc	慨
nvd	屡建奇功
nve	恨
nvf	忰
nvg	妀
nvh	 
nvi	心灵深处
nvj	 
nvk	怊
nvl	快刀斩乱麻
nvm	 
nvn	惟妙惟肖
nvo	 
nvp	舝
nvq	 
nvr	 
nvs	收录机
nvt	忉
nvu	 
nvv	尻
nvw	尽如人意
nvx	 
nvy	愤怒谴责
nwa	恰巧
nwb	怆
nwc	忪
nwd	居住面积
nwe	戮
nwf	飞禽走兽
nwg	恰
nwh	 
nwi	乆
nwj	刔
nwk	司令员
nwl	居全国之首
nwm	 
nwn	恰恰
nwo	 
nwp	剧作家
nwq	那会儿
nwr	那几年
nws	以偏概全
nwt	尉健行
nwu	司令部
nwv	凥
nww	恰似
nwx	尽人皆知
nwy	怜
nxa	导弹基地
nxb	导弹防御系统
nxc	 
nxd	已经成为
nxe	屁股
nxf	惯
nxg	憴
nxh	愼
nxi	以经济建设为中心
nxj	怫
nxk	 
nxl	 
nxm	 
nxn	惯性
nxo	 
nxp	已经完成
nxq	 
nxr	 
nxs	 
nxt	收费处
nxu	收费站
nxv	尼
nxw	惯例
nxx	屁
nxy	以飨读者
nya	以期
nyb	以及
nyc	民族矛盾
nyd	心态
nye	心脏
nyf	尺寸
nyg	以来
nyh	忭
nyi	尺
nyj	昼
nyk	惊
nyl	懔
nym	以内
nyn	忙
nyo	尺度
nyp	迟
nyq	以外
nyr	恼
nys	以西
nyt	㤃
nyu	尽
nyv	心灵
nyw	翠
nyx	迟缓
nyy	忟
oaa	遮蔽
oab	炎黄子孙
oac	度
oad	煤矿
oae	烧毁
oaf	煤
oag	灴
oah	庌
oai	㡲
oaj	灷
oak	廑
oal	煤田
oam	席
oan	炼
oao	遮
oap	煤窑
oaq	炼钢
oar	煤气
oas	 
oat	烧
oau	席卷
oav	 
oaw	粪
oax	烧结
oay	 
oba	底子薄
obb	㸎
obc	 
obd	 
obe	 
obf	廰
obg	籽
obh	邝
obi	 
obj	 
obk	 
obl	 
obm	炪
obn	灺
obo	 
obp	 
obq	 
obr	 
obs	㢌
obt	 
obu	 
obv	 
obw	廕
obx	鬯
oby	 
oca	烃
ocb	 
occ	 
ocd	糁
oce	熥
ocf	 
ocg	序列
och	 
oci	広
ocj	 
ock	序号
ocl	 
ocm	序曲
ocn	粑
oco	 
ocp	 
ocq	 
ocr	 
ocs	 
oct	㶼
ocu	 
ocv	 
ocw	焌
ocx	 
ocy	序言
oda	庆功
odb	广大职工
odc	炦
odd	庞大
ode	糊
odf	广大干部
odg	炻
odh	炋
odi	庆
odj	庵
odk	类别
odl	 
odm	烦
odn	烦恼
odo	精确度
odp	庆祝
odq	座右铭
odr	应有的
ods	数码相机
odt	爏
odu	类
odv	广大群众
odw	类似
odx	庞
ody	广大读者
oea	粗加工制品
oeb	烰
oec	 
oed	应用研究
oee	火腿肠
oef	㷐
oeg	粗
oeh	廋
oei	粗浅
oej	粗暴
oek	 
oel	爝
oem	 
oen	火力发电
oeo	粗糙
oep	燰
oeq	粗犷
oer	应用技术
oes	炒股票
oet	应用程序
oeu	粗壮
oev	 
oew	庾
oex	粗细
oey	粗放
ofa	焼
ofb	 
ofc	庋
ofd	庄
ofe	 
off	庤
ofg	灶
ofh	籵
ofi	庄浪
ofj	 
ofk	熺
ofl	庄园
ofm	广域网
ofn	炜
ofo	烤烟
ofp	㶿
ofq	庑
ofr	 
ofs	 
oft	烤
ofu	燵
ofv	 
ofw	广域信息服务系统
ofx	烟雾弥漫
ofy	籿
oga	精英
ogb	炖
ogc	精通
ogd	业
oge	精
ogf	精干
ogg	精致
ogh	炡
ogi	精湛
ogj	粳
ogk	焐
ogl	 
ogm	糟
ogn	精心
ogo	精度
ogp	精神
ogq	廒
ogr	精制
ogs	粖
ogt	业务
ogu	凿
ogv	廉政建设
ogw	业余
ogx	业绩
ogy	业主
oha	爈
ohb	 
ohc	 
ohd	䨾
ohe	床上用品
ohf	 
ohg	 
ohh	爠
ohi	店堂
ohj	焯
ohk	粘
ohl	粘连
ohm	粘贴
ohn	 
oho	 
ohp	店家
ohq	店铺
ohr	 
ohs	 
oht	废旧物资
ohu	 
ohv	 
ohw	 
ohx	庛
ohy	店主
oia	炒菜
oib	应聘
oic	应对
oid	应有
oie	应用
oif	应考
oig	应
oih	应战
oii	应当
oij	应是
oik	 
oil	 
oim	䊑
oin	应收
oio	广泛应用
oip	爣
oiq	应急
oir	广泛的
ois	摩洛哥
oit	炒
oiu	应将
oiv	 
oiw	应付
oix	 
oiy	应该
oja	爆
ojb	熶
ojc	 
ojd	爆破
oje	焨
ojf	焊
ojg	爆裂
ojh	灲
oji	㎎
ojj	焻
ojk	 
ojl	熳
ojm	庽
ojn	爆发
ojo	爆炸
ojp	 
ojq	焬
ojr	焊接
ojs	粿
ojt	爆竹
oju	煜
ojv	度日如年
ojw	 
ojx	精明强干
ojy	烛
oka	 
okb	火中取栗
okc	 
okd	 
oke	焆
okf	燥动
okg	炽烈
okh	 
oki	 
okj	 
okk	燥
okl	 
okm	熉
okn	废品收购
oko	 
okp	 
okq	炾
okr	炽热
oks	 
okt	 
oku	 
okv	 
okw	炽
okx	 
oky	废品率
ola	烟草
olb	 
olc	烟台
old	烟
ole	煟
olf	畨
olg	畑
olh	炠
oli	烟尘
olj	 
olk	库
oll	库车
olm	 
oln	㐣
olo	烟火
olp	库容
olq	 
olr	烟气
ols	火车票
olt	烟囱
olu	火车站
olv	廔
olw	业界人士
olx	 
oly	库房
oma	煤炭工业
omb	 
omc	 
omd	庙
ome	䊘
omf	腐败无能
omg	粙
omh	灿
omi	 
omj	熴
omk	炯
oml	 
omm	廮
omn	煱
omo	灿烂
omp	庙宇
omq	 
omr	 
oms	 
omt	㷨
omu	焵
omv	 
omw	业内人士
omx	精雕细刻
omy	数典忘祖
ona	 
onb	㐘
onc	 
ond	断面
one	爆发力
onf	废墟
ong	断裂
onh	糈
oni	応
onj	鹿
onk	废品
onl	㢞
onm	 
onn	焗
ono	废料
onp	断定
onq	断然
onr	断
ons	断档
ont	废
onu	断送
onv	断奶
onw	廖
onx	精心组织
ony	烬
ooa	火花
oob	郯
ooc	灯火通明
ood	粉煤灰
ooe	火力
oof	火场
oog	爆炸事件
ooh	火柴
ooi	火光
ooj	剡
ook	 
ool	火车
oom	火山
oon	廘
ooo	火
oop	火灾
ooq	欻
oor	灿烂的
oos	䊳
oot	火箭
oou	炎
oov	糖
oow	火化
oox	火红
ooy	炏
opa	数字式
opb	 
opc	数字通信
opd	精神面貌
ope	精神力量
opf	烷
opg	煊
oph	精神上
opi	迷
opj	数字电视
opk	迷路
opl	煇
opm	精神财富
opn	迷惘
opo	数字数据网
opp	精神实质
opq	精神解脱
opr	数字技术
ops	数字模型
opt	精神生活
opu	精神病
opv	 
opw	熔
opx	粮农组织
opy	精神文明建设
oqa	底
oqb	灮
oqc	 
oqd	燃
oqe	焰
oqf	燃起
oqg	底下
oqh	炊具
oqi	燃油
oqj	㶷
oqk	䊅
oql	 
oqm	焕
oqn	炮
oqo	燃料
oqp	 
oqq	摩尔多瓦
oqr	炮兵
oqs	 
oqt	底盘
oqu	底部
oqv	 
oqw	炊
oqx	炮弹
oqy	灼
ora	广播节目
orb	应邀出席
orc	数据通信
ord	烯
ore	 
orf	庪
org	粕
orh	炘
ori	粗制滥造
orj	广播电视
ork	庍
orl	摩托车
orm	广播网
orn	广播剧
oro	数据库
orp	 
orq	廆
orr	 
ors	䊛
ort	庳
oru	应邀前来
orv	 
orw	广播体操
orx	精打细算
ory	迷失方向
osa	 
osb	 
osc	磨难
osd	麻木不仁
ose	魔力
osf	灯塔
osg	粞
osh	灯
osi	床
osj	燂
osk	庁
osl	腐朽思想
osm	 
osn	 
oso	麻烦
osp	 
osq	床铺
osr	摩擦
oss	麻
ost	灯笼
osu	广西壮族自治区
osv	魔女
osw	床位
osx	磨练
osy	炑
ota	炸药
otb	庭院
otc	庅
otd	烽
ote	炸毁
otf	糙
otg	业务素质
oth	炸
oti	业务水平
otj	 
otk	烙
otl	庭园
otm	燠
otn	烁
oto	燔
otp	庭审
otq	烙印
otr	粮管所
ots	精简机构
ott	广告牌
otu	烀
otv	㸅
otw	业务人员
otx	炸弹
oty	敉
oua	庰
oub	粒子
ouc	 
oud	烂
oue	燧
ouf	料
oug	粒
ouh	糕点
oui	廉洁
ouj	燑
ouk	焙
oul	麻痹思想
oum	 
oun	焖
ouo	焙烧
oup	 
ouq	爓
our	广阔的
ous	料想
out	 
ouu	广阔前景
ouv	廉
ouw	廉价
oux	糍
ouy	燘
ova	康熙
ovb	㶢
ovc	 
ovd	数百
ove	庸
ovf	娄
ovg	籹
ovh	唐
ovi	康
ovj	数量
ovk	炤
ovl	爉
ovm	唐山
ovn	 
ovo	娄底
ovp	数字
ovq	 
ovr	数据
ovs	 
ovt	数
ovu	数次
ovv	 
ovw	庚
ovx	精妙绝伦
ovy	籾
owa	 
owb	炝
owc	庺
owd	煅
owe	业余爱好
owf	腐
owg	粉末
owh	煽风点火
owi	粉尘
owj	业余时间
owk	 
owl	座车
owm	腐败
own	籶
owo	腐烂
owp	 
owq	腐蚀
owr	类似的
ows	庥
owt	粮食生产
owu	粮食产量
owv	粉
oww	座
owx	烨
owy	焓
oxa	 
oxb	 
oxc	 
oxd	庼
oxe	㶭
oxf	 
oxg	 
oxh	粌
oxi	灯红酒绿
oxj	炥
oxk	糨
oxl	 
oxm	 
oxn	 
oxo	 
oxp	 
oxq	 
oxr	庇护
oxs	 
oxt	㢕
oxu	断绝关系
oxv	庀
oxw	断线风筝
oxx	庇
oxy	 
oya	广东
oyb	炉子
oyc	应变能力
oyd	㢇
oye	广交朋友
oyf	广场
oyg	广
oyh	炞
oyi	广泛
oyj	应该是
oyk	廓
oyl	廪
oym	庐山
oyn	炉
oyo	广度
oyp	广安
oyq	米饭
oyr	广播
oys	广西
oyt	米
oyu	熵
oyv	粮
oyw	粹
oyx	炫
oyy	炆
paa	赛区
pab	密切联系
pac	赛马
pad	究其原因
pae	社区服务
paf	赛场
pag	宽带
pah	宦
pai	宽敞
paj	寞
pak	赛跑
pal	赛车
pam	宽
pan	农工民主党
pao	宽度
pap	宽容
paq	塞外
par	赛后
pas	密切相关
pat	赛季
pau	寒冷
pav	社区建设
paw	赛
pax	密切结合
pay	农工商
pba	突出贡献
pbb	突出了
pbc	冣
pbd	字面
pbe	 
pbf	字
pbg	字形
pbh	实际上
pbi	实际水平
pbj	㝋
pbk	字号
pbl	实际困难
pbm	字典
pbn	实际情况
pbo	 
pbp	 
pbq	字句
pbr	实际的
pbs	字样
pbt	字符
pbu	实际问题
pbv	军队建设
pbw	字体
pbx	字母
pby	字迹
pca	 
pcb	神圣职责
pcc	 
pcd	客观存在
pce	 
pcf	客观规律
pcg	客观事物
pch	客观上
pci	实验小学
pcj	 
pck	实验中学
pcl	 
pcm	 
pcn	灾难性
pco	神通广大
pcp	实验室
pcq	 
pcr	宏观控制
pcs	 
pct	宏观管理
pcu	㝊
pcv	 
pcw	 
pcx	宏观经济
pcy	宏观调控
pda	 
pdb	完成了
pdc	宏
pdd	寄存
pde	寡
pdf	宕
pdg	割裂
pdh	割
pdi	 
pdj	害虫
pdk	突破口
pdl	宁夏回族自治区
pdm	 
pdn	突破性
pdo	割断
pdp	完成祖国统一大业
pdq	宠儿
pdr	寄托
pds	寄
pdt	寄生
pdu	寮
pdv	寡妇
pdw	宏伟
pdx	宠
pdy	寄语
pea	农药
peb	实用阶段
pec	 
ped	农大
pee	农用
pef	肎
peg	宜
peh	农具
pei	农
pej	家用电脑
pek	客服中心
pel	农田
pem	 
pen	农民
peo	农业
pep	农家
peq	农贸
per	农技
pes	农村
pet	农行
peu	农资
pev	农垦
pew	实用价值
pex	补助费
pey	农户
pfa	完工
pfb	完了
pfc	 
pfd	完成
pfe	冠县
pff	宗教
pfg	完整
pfh	守旧
pfi	宗
pfj	客运量
pfk	㝨
pfl	宗教界
pfm	守则
pfn	冠以
pfo	 
pfp	冠军
pfq	完
pfr	守护
pfs	 
pft	完备
pfu	守
pfv	完好
pfw	完全
pfx	宗旨
pfy	宗族
pga	定期
pgb	实现了
pgc	室
pgd	宣布
pge	家
pgf	宇
pgg	实事求是
pgh	定
pgi	家小
pgj	宣
pgk	富
pgl	家园
pgm	寅
pgn	写
pgo	家庭
pgp	宇宙
pgq	宝钢
pgr	完整的
pgs	定西
pgt	家长
pgu	农副产品
pgv	视死如归
pgw	宣传
pgx	家乡
pgy	宝
pha	安眠药
phb	官职
phc	 
phd	 
phe	官办
phf	初具规模
phg	寂
phh	视频点播
phi	 
phj	 
phk	官员
phl	 
phm	官网
phn	官
pho	 
php	寂寞
phq	官邸
phr	官兵
phs	 
pht	初战告捷
phu	㓀
phv	初步建立
phw	视频信号
phx	 
phy	官方
pia	 
pib	农学院
pic	宗法观念
pid	 
pie	宵
pif	初学者
pig	 
pih	 
pii	 
pij	客流量
pik	视觉器官
pil	 
pim	 
pin	 
pio	容光焕发
pip	 
piq	 
pir	空洞的
pis	宵禁
pit	礼尚往来
piu	㲾
piv	寖
piw	家常便饭
pix	额济纳旗
piy	被誉为
pja	 
pjb	穷日子
pjc	 
pjd	幂
pje	 
pjf	 
pjg	审理
pjh	审
pji	冠冕堂皇
pjj	䥌
pjk	定时器
pjl	 
pjm	寓
pjn	审慎
pjo	审时度势
pjp	审定
pjq	 
pjr	审批
pjs	审查
pjt	字里行间
pju	审判
pjv	宴
pjw	宴会
pjx	审结
pjy	冥
pka	 
pkb	 
pkc	 
pkd	富贵不能淫
pke	空中加油
pkf	空口无凭
pkg	宺
pkh	 
pki	 
pkj	实践是检验真理的唯一标准
pkk	宫
pkl	 
pkm	宝贵财富
pkn	宫殿
pko	宫灯
pkp	宝中之宝
pkq	寅吃卯粮
pkr	宝贵的
pks	空中楼阁
pkt	宫廷
pku	宝贵意见
pkv	守口如瓶
pkw	 
pkx	实践经验
pky	实践证明
pla	军区
plb	郓
plc	 
pld	祖国大陆
ple	军用
plf	军需
plg	寰
plh	皲
pli	农田水利
plj	军
plk	军品
pll	军团
plm	 
pln	军民
plo	军火
plp	军官
plq	 
plr	祖国的
pls	牢固树立
plt	军委
plu	军装
plv	军垦
plw	军人
plx	祖国统一
ply	军方
pma	 
pmb	 
pmc	 
pmd	初见成效
pme	 
pmf	宙
pmg	穷山恶水
pmh	 
pmi	 
pmj	冚
pmk	视同路人
pml	穷则思变
pmm	 
pmn	 
pmo	 
pmp	 
pmq	视同儿戏
pmr	 
pms	 
pmt	 
pmu	 
pmv	神丹妙药
pmw	 
pmx	 
pmy	 
pna	密切
pnb	军民联防
pnc	㝕
pnd	密码
pne	甯
pnf	密封
png	突发事件
pnh	寐
pni	 
pnj	蜜蜂
pnk	 
pnl	军民团结
pnm	賔
pnn	农民收入
pno	密度
pnp	实属罕见
pnq	密钥
pnr	农民技术员
pns	密植
pnt	蜜
pnu	冠心病
pnv	定心丸
pnw	寥
pnx	军民结合
pny	廴
poa	灾区
pob	农业院校
poc	灾难
pod	农业大学
poe	农业用地
pof	家庭教育
pog	农业现代化
poh	宋庆龄基金会
poi	 
poj	家庭影院
pok	 
pol	实业界
pom	家庭网络
pon	灾民
poo	 
pop	灾害
poq	农业银行
por	农业技术
pos	农业机械
pot	农业科技
pou	灾
pov	家庭妇女
pow	农业人口
pox	农业经济
poy	家庭主妇
ppa	安家落户
ppb	之际
ppc	写字台
ppd	实实在在
ppe	神农架
ppf	之二
ppg	之一
pph	之上
ppi	之流
ppj	 
ppk	之中
ppl	安定团结
ppm	之内
ppn	空军司令
ppo	之类
ppp	之
ppq	之外
ppr	之后
pps	写字楼
ppt	定额管理
ppu	㝎
ppv	空空如也
ppw	之余
ppx	视神经
ppy	家家户户
pqa	 
pqb	宛
pqc	 
pqd	突然袭击
pqe	 
pqf	安然无恙
pqg	豁然开朗
pqh	 
pqi	宨
pqj	 
pqk	冤
pql	 
pqm	寏
pqn	冤屈
pqo	 
pqp	冤家
pqq	鸩
pqr	 
pqs	冤枉
pqt	 
pqu	突然间
pqv	冘
pqw	㱽
pqx	塞尔维亚
pqy	农贸市场
pra	安排工作
prb	察看了
prc	寙
prd	安排不当
pre	 
prf	被迫进行
prg	宾
prh	实质上
pri	空气污染
prj	 
prk	 
prl	穷兵黩武
prm	 
prn	之所以
pro	 
prp	宾客
prq	宾馆
prr	空气质量
prs	审批权
prt	审批程序
pru	实质问题
prv	 
prw	 
prx	宁缺毋滥
pry	宾主
psa	宁蒗
psb	 
psc	 
psd	宁夏
pse	 
psf	农村干部
psg	宁静
psh	宁肯
psi	宁波
psj	宁
psk	 
psl	宁国
psm	 
psn	农村改革
pso	 
psp	宁安
psq	农村金融
psr	安哥拉
pss	宁可
pst	农林牧副渔
psu	宋
psv	农村建设
psw	农村信用合作社
psx	农村经济
psy	官样文章
pta	宅
ptb	农科院
ptc	客观
ptd	宣告成立
pte	寒冬腊月
ptf	宪
ptg	牢
pth	㝚
pti	宪法
ptj	寄生虫
ptk	额
ptl	客车
ptm	 
ptn	农牧民
pto	农牧业
ptp	额定
ptq	额外
ptr	客气
pts	客机
ptt	客船
ptu	宪章
ptv	 
ptw	客人
ptx	 
pty	客户
pua	褡
pub	实际
puc	衩
pud	实
pue	衫
puf	衬
pug	袜
puh	被
pui	裆
puj	裸
puk	裎
pul	裢
pum	袖
pun	褶
puo	裤
pup	衬衫
puq	袍
pur	裨
pus	襟
put	袄
puu	褙
puv	初
puw	裕
pux	襁
puy	褊
pva	突如其来
pvb	宄
pvc	 
pvd	宝刀不老
pve	 
pvf	安
pvg	安静
pvh	安上
pvi	福建省
pvj	 
pvk	安顺
pvl	安置
pvm	 
pvn	安居
pvo	安康
pvp	安定
pvq	案犯
pvr	安排
pvs	案
pvt	安徽
pvu	安装
pvv	 
pvw	安全
pvx	安乡
pvy	安放
pwa	穿
pwb	窿
pwc	空难
pwd	突
pwe	穷
pwf	察
pwg	窒
pwh	社会上
pwi	社会治安
pwj	窠
pwk	窝
pwl	社会团体
pwm	帘
pwn	窟
pwo	窭
pwp	窈窕
pwq	窕
pwr	窑
pws	完全可以
pwt	窗
pwu	穴
pwv	究
pww	容
pwx	穹
pwy	鹤
pxa	 
pxb	它
pxc	宖
pxd	 
pxe	 
pxf	 
pxg	军费开支
pxh	䙾
pxi	被统治阶级
pxj	 
pxk	神经中枢
pxl	 
pxm	 
pxn	 
pxo	 
pxp	迱
pxq	 
pxr	它的
pxs	 
pxt	神经系统
pxu	初级产品
pxv	 
pxw	它们
pxx	 
pxy	神经衰弱
pya	祺
pyb	祁
pyc	神圣
pyd	祷
pye	祖
pyf	社
pyg	福
pyh	祯
pyi	视觉
pyj	神
pyk	祝
pyl	祖国
pym	视
pyn	礼
pyo	礼炮
pyp	视察
pyq	祗
pyr	祈
pys	客户机
pyt	祚
pyu	祥
pyv	禄
pyw	社会
pyx	神经
pyy	禳
qaa	错落
qab	钳子
qac	多功能
qad	锘
qae	鏾
qaf	钳
qag	釭
qah	桀
qai	错觉
qaj	昏
qak	钷
qal	锚
qam	帋
qan	钜
qao	昏迷
qap	铹
qaq	金黄色
qar	急功近利
qas	 
qat	铙
qau	包工头
qav	氏
qaw	镬
qax	锋芒毕露
qay	邸
qba	危险期
qbb	鎁
qbc	镊
qbd	迎春
qbe	 
qbf	解除武装
qbg	铒
qbh	钌
qbi	䤴
qbj	争取时间
qbk	危险品
qbl	锰
qbm	鈯
qbn	怨
qbo	 
qbp	迎
qbq	鸳
qbr	迎接
qbs	锕
qbt	釢
qbu	迎新
qbv	外孙女
qbw	独联体
qbx	 
qby	怨言
qca	狂欢节
qcb	色
qcc	錣
qcd	犹豫不决
qce	色彩
qcf	勾魂
qcg	铎
qch	 
qci	勾
qcj	 
qck	鈶
qcl	䥁
qcm	 
qcn	钯
qco	鎷
qcp	 
qcq	鈗
qcr	勾搭
qcs	 
qct	鉾
qcu	金鸡奖
qcv	 
qcw	勾人
qcx	勾结
qcy	钗
qda	乌龙茶
qdb	危
qdc	钹
qdd	然而
qde	铕
qdf	锛
qdg	钴
qdh	锲
qdi	饶有兴趣
qdj	危在旦夕
qdk	 
qdl	 
qdm	钸
qdn	铖
qdo	 
qdp	危害
qdq	危急
qdr	厃
qds	危机
qdt	铸
qdu	镣
qdv	 
qdw	詹
qdx	銭
qdy	然
qea	角落
qeb	解除
qec	解难
qed	名胜古迹
qee	解脱
qef	臽
qeg	钥
qeh	角
qei	触觉
qej	钥匙
qek	鉫
qel	解围
qem	 
qen	触发
qeo	角度
qep	解密
qeq	角色
qer	触摸
qes	解析
qet	钐
qeu	解决
qev	包办婚姻
qew	解体
qex	 
qey	解放
qfa	销声匿迹
qfb	钻井队
qfc	针对
qfd	乌干达
qfe	 
qff	怨声载道
qfg	钍
qfh	针
qfi	镇江
qfj	 
qfk	锣鼓喧天
qfl	镭
qfm	钱财
qfn	釫
qfo	䤲
qfp	镇定
qfq	针灸
qfr	包干制
qfs	 
qft	锗
qfu	镇痛
qfv	 
qfw	多元化
qfx	钱
qfy	针剂
qga	鳓
qgb	钝
qgc	鲐
qgd	鱿
qge	铺
qgf	鱼
qgg	鲡
qgh	钙
qgi	印染
qgj	鲁
qgk	鳄
qgl	鳃
qgm	鲷
qgn	钺
qgo	鳞
qgp	鲩
qgq	鲍
qgr	鳇
qgs	鳔
qgt	鲦
qgu	鲜
qgv	鲫
qgw	鲋
qgx	鲜红
qgy	鲸
qha	独具匠心
qhb	外出
qhc	铍
qhd	䀏
qhe	外加
qhf	外地
qhg	钼
qhh	鑺
qhi	外汇
qhj	亇
qhk	钻
qhl	外国
qhm	鍞
qhn	触目惊心
qho	 
qhp	外宾
qhq	外贸
qhr	外援
qhs	钻机
qht	外长
qhu	外部
qhv	 
qhw	外债
qhx	外经
qhy	外
qia	名流荟萃
qib	急流险滩
qic	 
qid	包治百病
qie	销
qif	鼗
qig	玺
qih	覙
qii	兆
qij	销量
qik	销路
qil	饮水思源
qim	锁
qin	铴
qio	 
qip	逃
qiq	逃犯
qir	尔后
qis	钞票
qit	钞
qiu	尔
qiv	铛
qiw	销售
qix	 
qiy	釥
qja	鏎
qjb	郇
qjc	铿
qjd	旬
qje	 
qjf	锂
qjg	鈤
qjh	钊
qji	鎤
qjj	贸易量
qjk	﹙
qjl	镘
qjm	鍝
qjn	龟
qjo	 
qjp	贸易额
qjq	锡
qjr	贸易投资
qjs	锞
qjt	贸易往来
qju	贸易关系
qjv	 
qjw	贸易公司
qjx	锟
qjy	鉵
qka	名医
qkb	免除
qkc	 
qkd	句
qke	象
qkf	名
qkg	锃
qkh	钏
qki	名誉
qkj	名师
qkk	铝
qkl	名车
qkm	锅
qkn	铁路局
qko	锅炉
qkp	名字
qkq	够
qkr	名气
qks	象棋
qkt	名牌
qku	免疫
qkv	 
qkw	名人
qkx	免费
qky	名为
qla	 
qlb	 
qlc	䥯
qld	甸
qle	 
qlf	外国专家
qlg	钿
qlh	钾
qli	犯罪活动
qlj	解甲归田
qlk	䤧
qll	犯罪团伙
qlm	 
qln	锶
qlo	 
qlp	链
qlq	锣
qlr	外国投资
qls	 
qlt	链条
qlu	 
qlv	犯罪嫌疑人
qlw	外国人
qlx	镙
qly	外围设备
qma	负荷
qmb	铜陵
qmc	 
qmd	奂
qme	鏰
qmf	负载
qmg	铀
qmh	 
qmi	钢梁
qmj	铡
qmk	铜川
qml	钢轨
qmm	铜山
qmn	铠
qmo	负数
qmp	 
qmq	钢铁
qmr	钢
qms	钢材
qmt	钢筋
qmu	负
qmv	钢刀
qmw	钠
qmx	 
qmy	钡
qna	饶
qnb	饣
qnc	饴
qnd	锯
qne	馁
qnf	饯
qng	乌
qnh	钮
qni	饮水
qnj	蚀
qnk	馈
qnl	包围
qnm	馆内
qnn	钇
qno	饲料
qnp	馆
qnq	饮
qnr	饭
qns	馇
qnt	饰
qnu	饼
qnv	包
qnw	饥
qnx	铌
qny	饺
qoa	镀
qob	鑁
qoc	鉱
qod	昏迷不醒
qoe	鮾
qof	独断专行
qog	镤
qoh	鮍
qoi	匊
qoj	魝
qok	鰐
qol	魻
qom	魶
qon	镳
qoo	锬
qop	鱼米之乡
qoq	镀金
qor	魬
qos	魺
qot	锻炼身体
qou	炙
qov	镂
qow	多数人
qox	魮
qoy	钬
qpa	鑧
qpb	钻空子
qpc	 
qpd	负案在逃
qpe	䥱
qpf	金字塔
qpg	锭
qph	錧
qpi	 
qpj	 
qpk	 
qpl	鍕
qpm	 
qpn	危害性
qpo	䤹
qpp	危害社会
qpq	迎宾馆
qpr	镔
qps	危害极大
qpt	独家生产
qpu	 
qpv	铵
qpw	镲
qpx	铊
qpy	饥寒交迫
qqa	多项
qqb	外贸出口
qqc	钩
qqd	多大
qqe	多用
qqf	多云
qqg	鍂
qqh	多占
qqi	匇
qqj	多时
qqk	铭
qql	多国
qqm	金山
qqn	钨
qqo	多数
qqp	多家
qqq	金
qqr	锪
qqs	乌鲁木齐
qqt	铆
qqu	多
qqv	铮
qqw	钦
qqx	金乡
qqy	钓
qra	狠抓落实
qrb	匈
qrc	钣
qrd	铁矿
qre	勿
qrf	乌拉圭
qrg	铂
qrh	釿
qri	匁
qrj	刎
qrk	铁路
qrl	忽略
qrm	锦
qrn	忽
qro	 
qrp	忽视
qrq	锨
qrr	迎接挑战
qrs	铩
qrt	多年生
qru	铁道
qrv	 
qrw	铁
qrx	锦绣
qry	匆
qsa	多极世界
qsb	钉子
qsc	 
qsd	危机感
qse	 
qsf	镖
qsg	钵
qsh	钉
qsi	锡林浩特
qsj	镡
qsk	钶
qsl	危机四伏
qsm	 
qsn	多样性
qso	錰
qsp	锦标赛
qsq	 
qsr	多样的
qss	独木桥
qst	 
qsu	 
qsv	 
qsw	多样化
qsx	 
qsy	鈢
qta	猎
qtb	犯
qtc	狁
qtd	锋
qte	狙
qtf	猪
qtg	狂
qth	镍
qti	猜测
qtj	独
qtk	铬
qtl	猥
qtm	猾
qtn	儿
qto	狄
qtp	狞
qtq	狗
qtr	狐
qts	猹
qtt	猁
qtu	獍
qtv	狠
qtw	猴
qtx	狒
qty	狼
qua	儿童节
qub	解决了
quc	乌兰巴托
qud	匀
que	免疫力
quf	锌
qug	镁
quh	 
qui	独立法人
quj	镜
quk	锐
qul	独立思考
qum	䥕
qun	钔
quo	镨
qup	乌兰察布盟
quq	锵
qur	锐气
qus	独立核算
qut	铲
quu	铁道部
quv	解决好
quw	镒
qux	锑
quy	解决方案
qva	银幕
qvb	邹
qvc	急骤
qvd	争夺
qve	银
qvf	刍
qvg	钕
qvh	争
qvi	银河
qvj	鏁
qvk	铷
qvl	锱
qvm	争购
qvn	急
qvo	 
qvp	锓
qvq	银色
qvr	争执
qvs	争相
qvt	煞
qvu	争端
qvv	勼
qvw	雏
qvx	皱纹
qvy	争论
qwa	䤦
qwb	 
qwc	鈆
qwd	锻
qwe	鉁
qwf	多亿元
qwg	铨
qwh	狐假虎威
qwi	勽
qwj	销售量
qwk	铅
qwl	负债累累
qwm	欠帐
qwn	釠
qwo	锻炼
qwp	销售额
qwq	铝合金
qwr	欠缺
qws	迎风飘扬
qwt	欠税
qwu	欠
qwv	鈖
qww	锉
qwx	铧
qwy	铃
qxa	煞费苦心
qxb	 
qxc	 
qxd	 
qxe	 
qxf	久经考验
qxg	免费下载
qxh	鈏
qxi	铺张浪费
qxj	镄
qxk	镪
qxl	 
qxm	外引内联
qxn	 
qxo	 
qxp	 
qxq	久经锻炼
qxr	 
qxs	钢结构
qxt	错综复杂
qxu	锦绣前程
qxv	匂
qxw	饱经风霜
qxx	锴
qxy	鉧
qya	解放区
qyb	解放出来
qyc	铳
qyd	訇
qye	铱
qyf	䚻
qyg	留下
qyh	解放战争
qyi	久
qyj	贸易
qyk	镶
qyl	解放思想
qym	铈
qyn	鸟
qyo	灸
qyp	解放军
qyq	久久
qyr	错误的
qys	 
qyt	钫
qyu	镑
qyv	留
qyw	铰
qyx	铉
qyy	鈫
raa	拭
rab	皂
rac	兵荒马乱
rad	撕
rae	撒
raf	摸索
rag	扛
rah	白萝卜
rai	摸清
raj	措
rak	报警器
ral	描
ram	近期内
ran	拒
rao	摸底
rap	捞
raq	技工贸
rar	抠
ras	搭配
rat	挠
rau	后勤部
rav	打工妹
raw	搭
rax	拒绝
ray	找
rba	报警
rbb	揶
rbc	报
rbd	撱
rbe	 
rbf	报刊
rbg	挕
rbh	邤
rbi	拯
rbj	摄影
rbk	凶
rbl	报国
rbm	拙
rbn	扡
rbo	报废
rbp	报社
rbq	据了解
rbr	提出的
rbs	报酬
rbt	扔
rbu	报道
rbv	 
rbw	报价
rbx	报纸
rby	报请
rca	拚
rcb	摊子
rcc	掇
rcd	掺
rce	捅
rcf	反动
rcg	择
rch	摊点
rci	反
rcj	反映
rck	抬
rcl	返回
rcm	摊贩
rcn	把
rco	反应
rcp	返
rcq	反馈
rcr	把握
rcs	反对票
rct	挨
rcu	㿝
rcv	 
rcw	摊
rcx	返乡
rcy	瓜
rda	振荡
rdb	扼
rdc	拔
rdd	振奋
rde	肴
rdf	振
rdg	拓
rdh	看在眼里
rdi	振兴
rdj	掩
rdk	制成品
rdl	誓不罢休
rdm	希
rdn	扰
rdo	振奋精神
rdp	挞
rdq	掩饰
rdr	所有的
rds	掎
rdt	扰乱
rdu	撩
rdv	技压群芳
rdw	捧
rdx	拢
rdy	扙
rea	势力范围
reb	摆脱了
rec	授予
red	拥有
ree	援助
ref	捋
reg	援
reh	拥
rei	摇滚
rej	摇晃
rek	授勋
rel	摆脱困境
rem	 
ren	 
reo	授粉
rep	授
req	掏腰包
rer	摇
res	授权
ret	劤
reu	摇头
rev	搜寻
rew	搜集
rex	援引
rey	授课
rfa	技巧
rfb	推动了
rfc	技
rfd	持有
rfe	推动力
rff	持
rfg	扗
rfh	盾
rfi	技法
rfj	皁
rfk	拮
rfl	擂
rfm	质
rfn	抟
rfo	指示精神
rfp	挝
rfq	抚
rfr	扶持
rfs	技术
rft	拷
rfu	抚养
rfv	报刊杂志
rfw	扶
rfx	持续
rfy	扭亏为盈
rga	后期
rgb	邱
rgc	后劲
rgd	丘
rge	搏
rgf	皇
rgg	抂
rgh	扌
rgi	执政党
rgj	后果
rgk	后
rgl	兵团
rgm	岳
rgn	后来居上
rgo	反政府武装
rgp	遑
rgq	捕鱼
rgr	捕捉
rgs	抹
rgt	乒
rgu	挟
rgv	捷
rgw	兵
rgx	后续
rgy	乓
rha	掳
rhb	卸
rhc	披
rhd	排
rhe	年月
rhf	看
rhg	扯
rhh	攫
rhi	看法
rhj	掉
rhk	拈
rhl	年轻
rhm	年内
rhn	白皮书
rho	年底
rhp	年初
rhq	排外
rhr	年后
rhs	年检
rht	排版
rhu	年前
rhv	看好
rhw	年代
rhx	年级
rhy	扑
ria	
rib	邾
ric	 
rid	执法不严
rie	捎
rif	按常规
rig	抗洪救灾
rih	扬汤止沸
rii	朱
rij	执法监督
rik	热水器
ril	搞活国营大中型企业
rim	 
rin	执法必严
rio	 
rip	搅
riq	 
rir	抗洪抢险
ris	执法检查
rit	抄
riu	泉
riv	挡
riw	执法人员
rix	搞活经济
riy	泉州
rja	揭幕
rjb	撮
rjc	 
rjd	提成
rje	担架
rjf	捏
rjg	担
rjh	刈
rji	担当
rjj	揭晓
rjk	质量品种效益年
rjl	按照国际惯例
rjm	 
rjn	担心
rjo	提炼
rjp	提案
rjq	揭
rjr	提拔
rjs	提醒
rjt	揽
rju	提前
rjv	 
rjw	提供
rjx	拽
rjy	提高
rka	兵器工业
rkb	揖
rkc	挹
rkd	损耗
rke	拐
rkf	捐款
rkg	扣
rkh	捉
rki	 
rkj	︵
rkk	操
rkl	 
rkm	损
rkn	操心
rko	 
rkp	损害
rkq	扣留
rkr	损失
rks	拐杖
rkt	捷足先登
rku	捐资
rkv	 
rkw	操作
rkx	操纵
rky	近距离
rla	 
rlb	打黑除恶
rlc	舞台
rld	摁
rle	摆脱
rlf	摆
rlg	舞
rlh	押
rli	摆满
rlj	年轻时
rlk	舞蹈
rll	攂
rlm	 
rln	舞剧
rlo	 
rlp	按国家有关规定
rlq	押金
rlr	摆摊
rls	捆
rlt	撂
rlu	舞弊
rlv	舞女
rlw	年轻人
rlx	摞
rly	摆设
rma	罐
rmb	缺陷
rmc	 
rmd	揣
rme	摧毁
rmf	制裁
rmg	抽
rmh	制
rmi	缺少
rmj	罎
rmk	缶
rml	制图
rmm	撄
rmn	缺
rmo	制度
rmp	制定
rmq	抽象
rmr	所见所闻
rms	抽查
rmt	制造
rmu	制冷
rmv	 
rmw	摧
rmx	制约
rmy	制订
rna	抿
rnb	气
rnc	氢
rnd	据
rne	挪用
rnf	所需
rng	握
rnh	扭
rni	气温
rnj	氘
rnk	氚
rnl	氤
rnm	氙
rnn	扎
rno	氮
rnp	氨
rnq	气象
rnr	所
rns	扎根
rnt	拨
rnu	氧
rnv	氯
rnw	氛
rnx	氟
rny	拟
roa	摭
rob	拒腐防变
roc	拡
rod	扩大
roe	 
rof	反应堆
rog	擈
roh	掂
roi	 
roj	掂量
rok	气焰嚣张
rol	 
rom	反腐败斗争
ron	扩展
roo	推广应用
rop	扩容
roq	掋
ror	年度报告
ros	擵
rot	扩
rou	搪瓷
rov	搂
row	制度化
rox	扩张
roy	扩充
rpa	近期
rpb	制定了
rpc	 
rpd	迫
rpe	控股
rpf	皖
rpg	揎
rph	按此
rpi	探测
rpj	按照
rpk	近
rpl	挥
rpm	捉襟见肘
rpn	挥发
rpo	按摩
rpp	近视
rpq	按钮
rpr	摈
rps	拧
rpt	近乎
rpu	探亲
rpv	按
rpw	控
rpx	拕
rpy	探讨
rqa	抵
rqb	抑
rqc	鬼
rqd	的确
rqe	掐
rqf	欣喜
rqg	捦
rqh	手急眼快
rqi	挑
rqj	挑剔
rqk	挽
rql	挽回
rqm	换
rqn	抱
rqo	掬
rqp	鬼神
rqq	揿
rqr	掏
rqs	打印机
rqt	挑选
rqu	气象站
rqv	挣
rqw	欣
rqx	打印纸
rqy	的
rra	逝世
rrb	拆除
rrc	扳
rrd	气势磅礴
rre	魄力
rrf	拍卖
rrg	拍
rrh	折
rri	哲学
rrj	蜇
rrk	哲
rrl	扳回
rrm	劕
rrn	白发
rro	折磨
rrp	逝
rrq	掀
rrr	白
rrs	拖拉机
rrt	捭
rru	爻
rrv	抓好
rrw	抓住
rrx	白纸
rry	拆
rsa	弑
rsb	技术承包
rsc	打通
rsd	打破
rse	技术服务
rsf	技术进步
rsg	拪
rsh	打
rsi	技术水平
rsj	刹
rsk	技术中心
rsl	技术转让
rsm	技术骨干
rsn	技术改造
rso	技术应用
rsp	技术密集
rsq	打印
rsr	技术指标
rss	打桩
rst	打算
rsu	杀
rsv	打好
rsw	技术人员
rsx	技术引进
rsy	技术市场
rta	托
rtb	拖
rtc	持乐观态度
rtd	括
rte	搬
rtf	插
rtg	手
rth	攥
rti	手法
rtj	播映
rtk	手中
rtl	报告团
rtm	手册
rtn	执行情况
rto	播
rtp	手写
rtq	拖欠
rtr	手持
rts	手术
rtt	斤
rtu	投入产出
rtv	挺好
rtw	手段
rtx	手续
rty	乂
rua	拼
rub	搠
ruc	接通
rud	拦
rue	接受
ruf	抖
rug	拉
ruh	热闹非凡
rui	搁浅
ruj	撞
ruk	掊
rul	掸
rum	撇
run	扪
ruo	扑朔迷离
rup	投资额
ruq	接触
rur	接近
rus	撙
rut	搁
ruu	接着
ruv	接
ruw	年产值
rux	接纳
ruy	热门话题
rva	执勤
rvb	招聘
rvc	热能
rvd	挚友
rve	抛
rvf	扫雷
rvg	扫
rvh	热点
rvi	执法
rvj	热量
rvk	招
rvl	擸
rvm	招贴
rvn	殷
rvo	招数
rvp	殷实
rvq	拶
rvr	扫描
rvs	招标
rvt	㧅
rvu	势头
rvv	扫帚
rvw	热风
rvx	热线
rvy	势
rwa	推荐
rwb	抢
rwc	投
rwd	ア
rwe	推脱
rwf	拊
rwg	拾
rwh	抢占
rwi	失
rwj	投影
rwk	操作员
rwl	白俄罗斯
rwm	失败
rwn	推迟
rwo	推广
rwp	迭
rwq	推销
rwr	近几年
rws	投票
rwt	投入
rwu	㒵
rwv	扮
rww	挫
rwx	抡
rwy	扒
rxa	墍
rxb	皀
rxc	批驳
rxd	后继有人
rxe	拗
rxf	掼
rxg	掾
rxh	指点
rxi	指派
rxj	指
rxk	批号
rxl	批转
rxm	㨥
rxn	㧈
rxo	指数
rxp	指定
rxq	指针
rxr	指挥
rxs	指标
rxt	指向
rxu	搦
rxv	报纸杂志
rxw	指令
rxx	批
rxy	拇
rya	希望工程
ryb	提高了
ryc	撤
ryd	挤压
rye	护肤
ryf	护士
ryg	拄
ryh	抗战
ryi	斥
ryj	挤
ryk	搞
ryl	擅
rym	 
ryn	护
ryo	 
ryp	撤军
ryq	撤销
ryr	所说的
rys	摘要
ryt	邀
ryu	摘
ryv	搞好
ryw	抗
ryx	摔
ryy	邀请
saa	械
sab	栉
sac	柜台
sad	棋
sae	框架
saf	柑
sag	杠
sah	榧
sai	栋
saj	模
sak	槿
sal	框图
sam	横
san	柜
sao	模糊
sap	檬
saq	柩
sar	枢
sas	模板
sat	桡
sau	欗
sav	相敬如宾
saw	模仿
sax	本世纪
say	杙
sba	极其
sbb	椰
sbc	楹
sbd	椭
sbe	李鹏
sbf	李
sbg	杍
sbh	邒
sbi	极小
sbj	极易
sbk	 
sbl	椭圆
sbm	柮
sbn	杝
sbo	极度
sbp	 
sbq	 
sbr	可耻的
sbs	桗
sbt	㭁
sbu	极端
sbv	极好
sbw	极低
sbx	 
sby	极
sca	树苗
scb	权限
scc	棳
scd	权威
sce	桶
scf	树
scg	杩
sch	 
sci	 
scj	 
sck	树叶
scl	㮭
scm	 
scn	杷
sco	 
scp	 
scq	㭇
scr	权势
scs	树木
sct	权利
scu	树立
scv	 
scw	梭
scx	 
scy	权
sda	枯萎
sdb	椅子
sdc	想不通
sdd	酿成大祸
sde	枥
sdf	极大地
sdg	枯
sdh	杯
sdi	枯水
sdj	可不是
sdk	槗
sdl	 
sdm	顶
sdn	权威性
sdo	枯燥
sdp	橱窗
sdq	顶多
sdr	极大的
sds	椅
sdt	梆
sdu	䙲
sdv	 
sdw	棒
sdx	栊
sdy	杖
sea	校办工厂
seb	桴
sec	 
sed	 
see	棚
sef	横加干涉
seg	桕
seh	㮴
sei	想办法
sej	核力量
sek	枷
sel	 
sem	 
sen	 
seo	 
sep	橓
seq	枷锁
ser	横加指责
ses	权力机关
set	杉
seu	橳
sev	桵
sew	楰
sex	榽
sey	 
sfa	本地区
sfb	鄄
sfc	枝
sfd	票面
sfe	核动力
sff	桂
sfg	杜
sfh	杆
sfi	票
sfj	标题
sfk	桔
sfl	檑
sfm	楠
sfn	椟
sfo	材料
sfp	植被
sfq	村镇
sfr	票据
sfs	植树
sft	材
sfu	樯
sfv	樰
sfw	棱
sfx	栈
sfy	村
sga	醋
sgb	酏
sgc	酸
sgd	本
sge	酹
sgf	酵
sgg	枉
sgh	丁
sgi	西洋
sgj	醒
sgk	梧
sgl	楝
sgm	槽
sgn	配
sgo	醚
sgp	酡
sgq	酌
sgr	酗
sgs	酊
sgt	酷
sgu	醅
sgv	要更好地
sgw	酚
sgx	酯
sgy	醉
sha	椃
shb	想出
shc	相对
shd	榜上有名
she	相助
shf	相声
shg	相
shh	欋
shi	相当
shj	棹
shk	相距
shl	相连
shm	桢
shn	想
sho	相应
shp	朴实
shq	想象
shr	相反
shs	相配
sht	相符
shu	相关
shv	 
shw	相信
shx	相比
shy	朴
sia	根深蒂固
sib	 
sic	相当艰巨
sid	瓢泼大雨
sie	梢
sif	相当规模
sig	榉
sih	 
sii	桫
sij	㭼
sik	检测中心
sil	杯水车薪
sim	㭻
sin	可溶性
sio	极少数
sip	樘
siq	相当多的
sir	相当的
sis	相当可观
sit	杪
siu	档次
siv	档
siw	 
six	 
siy	㭂
sja	查获
sjb	查出
sjc	查验
sjd	相映成趣
sje	查办
sjf	杳
sjg	查
sjh	查明具报
sji	查清
sjj	查明
sjk	 
sjl	榅
sjm	查帐
sjn	榻
sjo	 
sjp	查实
sjq	楬
sjr	查找
sjs	棵
sjt	槛
sju	核电站
sjv	 
sjw	 
sjx	棍
sjy	查询
ska	可敬
skb	楫
skc	可能
skd	可
ske	柺
skf	杏
skg	枵
skh	杊
ski	歌唱演员
skj	可是
skk	榀
skl	 
skm	可见
skn	可以
sko	歌迷
skp	歌唱家
skq	柷
skr	歌舞
sks	哥
skt	可靠
sku	可亲
skv	可好
skw	枳
skx	可比
sky	可谓
sla	槶
slb	 
slc	 
sld	栶
sle	㭷
slf	㭗
slg	柶
slh	柙
sli	 
slj	 
slk	 
sll	櫑
slm	 
sln	楒
slo	 
slp	梿
slq	椤
slr	 
sls	相辅相成
slt	核辐射
slu	 
slv	櫢
slw	楐
slx	樏
sly	楞
sma	椣
smb	票贩子
smc	 
smd	柍
sme	榾
smf	枏
smg	柚
smh	杣
smi	李岚清
smj	 
smk	 
sml	 
smm	栅
smn	桤
smo	 
smp	相同之处
smq	枧
smr	
sms	栅栏
smt	 
smu	贾
smv	 
smw	枘
smx	桐乡
smy	梖
sna	榐
snb	朰
snc	本性难移
snd	椐
sne	核心力量
snf	㭄
sng	栩
snh	楣
sni	樨
snj	蚻
snk	椲
snl	 
snm	 
snn	札
sno	 
snp	核心家庭
snq	可以忽视
snr	杨
sns	橄榄
snt	酌情处理
snu	核心问题
snv	横眉怒目
snw	核心作用
snx	柅
sny	杺
soa	樜
sob	杰出
soc	相应对策
sod	材料厂
soe	 
sof	桩
sog	楼下
soh	 
soi	 
soj	㔄
sok	 
sol	 
som	 
son	林业局
soo	棪
sop	楼宇
soq	橉
sor	相应措施
sos	贾庆林
sot	材料科学
sou	杰
sov	楼
sow	杰作
sox	材料费
soy	楼房
spa	 
spb	检察院
spc	 
spd	廼
spe	顶礼膜拜
spf	棕
spg	楦
sph	棺
spi	 
spj	可视电话
spk	检察员
spl	可视图文
spm	 
spn	梦寐以求
spo	 
spp	检察官
spq	枕
spr	槟
sps	柠
spt	检察长
spu	枕头
spv	桉
spw	榷
spx	柁
spy	西安市
sqa	柢
sqb	枊
sqc	构
sqd	桅
sqe	桷
sqf	格鲁吉亚
sqg	橹
sqh	 
sqi	桃
sqj	 
sqk	橡
sql	构思
sqm	㭥
sqn	枹
sqo	椈
sqp	 
sqq	栘
sqr	杭锦后旗
sqs	构想
sqt	柳
squ	枃
sqv	构建
sqw	构件
sqx	 
sqy	榴
sra	棉花
srb	概括了
src	板
srd	槔
sre	可接受性
srf	根据需要
srg	柏
srh	析
sri	株
srj	晳
srk	 
srl	歌舞团
srm	棉
srn	歌舞剧
sro	本年度
srp	棉农
srq	槐
srr	攀
srs	柏林
srt	攀升
sru	相提并论
srv	 
srw	攀登
srx	可持续发展
sry	檄
ssa	林区
ssb	郴
ssc	 
ssd	机械厂
sse	彬
ssf	禁
ssg	栖
ssh	朾
ssi	林海
ssj	楂
ssk	柯
ssl	检查团
ssm	木雕
ssn	楚
sso	焚
ssp	检查官
ssq	梦
ssr	机械制造
sss	森
sst	根本利益
ssu	栗
ssv	婪
ssw	梵
ssx	检查组
ssy	林
sta	枨
stb	横向联合
stc	棋逢对手
std	桥
ste	可利用
stf	橇
stg	桁
sth	柞
sti	桥梁
stj	横征暴敛
stk	格
stl	植物园
stm	榭
stn	栎
sto	楸
stp	可乘之机
stq	格外
str	 
sts	可移植性
stt	覆
stu	䅇
stv	㮃
stw	村委会
stx	梅
sty	枚
sua	样式
sub	西门子
suc	检阅台
sud	栏
sue	相差悬殊
suf	梓
sug	样
suh	栏目
sui	机关党委
suj	樟
suk	榈
sul	梯田
sum	 
sun	相关性
suo	椪
sup	本着实事求是的原则
suq	极端负责
sur	相关的
sus	樽
sut	极端重要
suu	本部门
suv	椄
suw	标准化
sux	梯
suy	覆盖率
sva	根基
svb	根除
svc	概
svd	要不
sve	根
svf	要
svg	楗
svh	要点
svi	棣
svj	要是
svk	要员
svl	要略
svm	 
svn	朹
svo	棂
svp	要害
svq	要饭
svr	根据
svs	根本
svt	朷
svu	概况
svv	要好
svw	概念
svx	要强
svy	概率
swa	松散
swb	枪
swc	松
swd	椴
swe	 
swf	桧
swg	检
swh	机上
swi	检测
swj	机遇
swk	机器
swl	机车
swm	 
swn	机
swo	机床
swp	检察
swq	树倒猢狲散
swr	枫
sws	机构
swt	机种
swu	机关
swv	机群
sww	麴
swx	桦
swy	椎
sxa	 
sxb	 
sxc	 
sxd	棉纺厂
sxe	柪
sxf	＋
sxg	椽
sxh	槇
sxi	 
sxj	杯弓蛇影
sxk	㯞
sxl	相比较
sxm	 
sxn	朼
sxo	 
sxp	相比之下
sxq	 
sxr	可维护性
sxs	西红柿
sxt	 
sxu	相继问世
sxv	 
sxw	相结合
sxx	楷
sxy	栂
sya	西方世界
syb	述职
syc	梳
syd	可望而不可及
sye	西方舆论
syf	槠
syg	柱
syh	 
syi	术
syj	核电
syk	槁
syl	檀
sym	柿
syn	核
syo	〡
syp	述
syq	校外
syr	西方反华势力
sys	⒒
syt	枋
syu	榜
syv	榔
syw	校
syx	西方经济
syy	杭州
taa	长期
tab	筇
tac	 
tad	箕
tae	各区县
taf	笁
tag	筐
tah	逄
tai	长江
taj	长虹
tak	升
tal	筪
tam	簧
tan	长期以来
tao	彻底
tap	升官
taq	簪
tar	长期的
tas	穆斯林
tat	长征
tau	䇝
tav	乇
taw	筑
tax	升级
tay	长
tba	季节
tbb	竾
tbc	箃
tbd	自卫还击
tbe	 
tbf	季
tbg	秄
tbh	䄦
tbi	透光
tbj	透明
tbk	 
tbl	 
tbm	秀山
tbn	彵
tbo	季度
tbp	透
tbq	透镜
tbr	秀
tbs	各院校
tbt	䄧
tbu	秀美
tbv	䈨
tbw	季风
tbx	 
tby	笈
tca	径
tcb	笆
tcc	很难预料
tcd	私有
tce	筩
tcf	先驱者
tcg	笃
tch	 
tci	径流
tcj	 
tck	笞
tcl	 
tcm	 
tcn	㸭
tco	 
tcp	 
tcq	 
tcr	智能控制
tcs	很难想象
tct	私自
tcu	么
tcv	黎巴嫩
tcw	私人
tcx	微观经济
tcy	私
tda	甜
tdb	科研院所
tdc	智能
tdd	舌
tde	适用
tdf	䇢
tdg	牯
tdh	逢
tdi	夭
tdj	乔
tdk	智
tdl	短暂
tdm	岙
tdn	乱
tdo	适应
tdp	适
tdq	舐
tdr	很大的
tds	犄
tdt	敌
tdu	矢
tdv	筹建
tdw	雉
tdx	笼
tdy	㣕
tea	舡
teb	稃
tec	备受欢迎
ted	船厂
tee	稻
tef	航运
teg	租
teh	舻
tei	舟
tej	艃
tek	笳
tel	盘
tem	舰
ten	艉
teo	稻米
tep	舵
teq	利用外资
ter	务
tes	舸
tet	艇
teu	艟
tev	穏
tew	般
tex	舭
tey	航
tfa	垂
tfb	选出
tfc	丢
tfd	壬
tfe	歃
tff	竺
tfg	牡
tfh	秆
tfi	选举
tfj	午
tfk	千
tfl	德
tfm	牡丹
tfn	毛
tfo	待业
tfp	廷
tfq	先
tfr	选择
tfs	造林
tft	箸
tfu	乖
tfv	选好
tfw	自动化
tfx	笺
tfy	造就
tga	笄
tgb	得到了
tgc	行驶
tgd	生
tge	箐
tgf	竽
tgg	彺
tgh	征
tgi	生活
tgj	重
tgk	牛
tgl	熏
tgm	策
tgn	管理局
tgo	徕
tgp	重视
tgq	第一名
tgr	第一批
tgs	行
tgt	＾
tgu	秤
tgv	秉
tgw	生命
tgx	重组
tgy	行为
tha	算
thb	牌子
thc	彼
thd	自
the	自办
thf	怎
thg	片
thh	徙
thi	处
thj	昝
thk	咎
thl	鼻
thm	自由
thn	息
tho	片断
thp	延
thq	自然
thr	臭氧
ths	臬
tht	竹
thu	自立
thv	自如
thw	犋
thx	延续
thy	自主
tia	自治区
tib	科学院
tic	微波通讯
tid	科学研究
tie	稍
tif	自觉地
tig	簿
tih	生活上
tii	生活水平
tij	每小时
tik	特派员
til	科学界
tim	徜
tin	科学性
tio	科学精神
tip	科学家
tiq	秒钟
tir	箔
tis	选举权
tit	秒
tiu	尓
tiv	稍好
tiw	稍候
tix	生活费
tiy	生活方式
tja	复苏
tjb	得出
tjc	千里马
tjd	复原
tje	利用
tjf	香
tjg	得
tjh	利
tji	香港
tjj	复归
tjk	香味
tjl	得罪
tjm	香山
tjn	得以
tjo	香烟
tjp	复审
tjq	复印
tjr	复制
tjs	梨
tjt	复
tju	䖝
tjv	复杂
tjw	复合
tjx	复线
tjy	利率
tka	各项
tkb	种子
tkc	䇼
tkd	各有
tke	各县
tkf	各
tkg	和
tkh	种
tki	各省
tkj	特别是
tkk	稆
tkl	各国
tkm	禹
tkn	各异
tko	程序
tkp	积案
tkq	和解
tkr	程控
tks	积极
tkt	各种
tku	各部
tkv	和好
tkw	积
tkx	各级
tky	各方
tla	粤东
tlb	积累了
tlc	犤
tld	血
tle	备用
tlf	备
tlg	牭
tlh	备战
tli	血液
tlj	笚
tlk	徊
tll	我国国情
tlm	血肉
tln	惫
tlo	粤
tlp	我国社会主义
tlq	箩
tlr	囟
tls	血本
tlt	血管
tlu	衅
tlv	各界群众
tlw	稷
tlx	我国经济
tly	特困户
tma	向东
tmb	身子
tmc	微观
tmd	身
tme	身边
tmf	笛
tmg	微
tmh	币
tmi	微波
tmj	屲
tmk	向
tml	微软
tmm	向内
tmn	身心
tmo	奥
tmp	身穿
tmq	秽
tmr	身后
tms	微机
tmt	微笑
tmu	筫
tmv	奥妙
tmw	身体
tmx	射线
tmy	㸽
tna	各司其职
tnb	乞
tnc	乐观
tnd	愁眉不展
tne	向心力
tnf	乐趣
tng	笥
tnh	徦
tni	乐
tnj	刉
tnk	乐器
tnl	乐团
tnm	乐曲
tnn	筷
tno	得心应手
tnp	迄
tnq	秘鲁
tnr	自己的
tns	身居要职
tnt	秘
tnu	乐意
tnv	称心如意
tnw	迄今
tnx	乱收费
tny	各民族
toa	穬
tob	䎹
toc	释
tod	程度不同
toe	翻腾
tof	秩序井然
tog	秋天
toh	 
toi	釆
toj	番禺
tok	程序员
tol	翻
tom	釉
ton	愁
too	秋粮
top	翻案
toq	彻底解决
tor	翻看
tos	醔
tot	秋季
tou	夈
tov	篓
tow	秋风
tox	释疑
toy	秋
tpa	知之甚少
tpb	管子
tpc	 
tpd	行之有效
tpe	管用
tpf	稳定增长
tpg	稼
tph	管
tpi	航空港
tpj	很容易
tpk	乏味
tpl	管辖
tpm	 
tpn	稳定性
tpo	延安精神
tpp	管家
tpq	箢
tpr	管制
tps	管材
tpt	长安街
tpu	乏
tpv	管好
tpw	箜
tpx	管线
tpy	称之为
tqa	自然世界
tqb	衡阳
tqc	适销对路
tqd	衡
tqe	物力
tqf	移动
tqg	衔
tqh	稳步
tqi	称
tqj	徇
tqk	笱
tql	自然界
tqm	衡山
tqn	移民
tqo	知名度
tqp	稳定
tqq	移
tqr	物
tqs	移植
tqt	黎
tqu	物资
tqv	稳
tqw	物价
tqx	自然经济
tqy	称为
tra	箍
trb	科技队伍
trc	箨
trd	稀
tre	科技服务
trf	循
trg	徨
trh	御
tri	穆
trj	科技日报
trk	筘
trl	我国
trm	长白山
trn	臭氧层
tro	秩序
trp	我军
trq	篼
trr	科技投入
trs	我想
trt	稗
tru	科技部
trv	 
trw	秩
trx	我
try	徼
tsa	奥林匹克
tsb	箱子
tsc	积极参与
tsd	重要原因
tse	重要力量
tsf	䇴
tsg	牺
tsh	箱
tsi	重要渠道
tsj	簟
tsk	牱
tsl	重要因素
tsm	重要内容
tsn	积极性
tso	种植业
tsp	积极宣传
tsq	盘根错节
tsr	重要的
tss	篥
tst	牺牲
tsu	条
tsv	 
tsw	条件
tsx	条约
tsy	秫
tta	生物工程
ttb	生物防治
ttc	行得通
ttd	笑
tte	怎么办
ttf	笔
ttg	牲
tth	筵
tti	生物学
ttj	稪
ttk	乘务员
ttl	篦
ttm	䉛
ttn	秭
tto	各行业
ttp	笑容
ttq	笔触
ttr	生物技术
tts	怎么样
ttt	禾
ttu	自筹资金
ttv	重复建设
ttw	筹委会
ttx	龝
tty	牧
tua	生产基地
tub	简陋
tuc	生产能力
tud	科研
tue	箭
tuf	笠
tug	徉
tuh	科目
tui	科学
tuj	简
tuk	税
tul	箪
tum	徶
tun	税收
tuo	身兼数职
tup	乘客
tuq	税金
tur	乊
tus	简要
tut	科委
tuu	冬
tuv	生产建设
tuw	简化
tux	乘
tuy	简讯
tva	很苦
tvb	 
tvc	很难
tvd	很大
tve	很
tvf	委
tvg	律
tvh	覣
tvi	箫
tvj	律师
tvk	笤
tvl	很轻
tvm	 
tvn	很快
tvo	簘
tvp	逶
tvq	很多
tvr	魏
tvs	 
tvt	笋
tvu	很冷
tvv	很好
tvw	很低
tvx	很强
tvy	很高
twa	筏
twb	秃
twc	役
twd	颓
twe	生命力
twf	符
twg	徐
twh	筱
twi	黏
twj	长途电话
twk	符号
twl	签署
twm	生命财产
twn	篌
two	我们应该
twp	答案
twq	签名
twr	我们的
tws	我们要
twt	答复
twu	秂
twv	凢
tww	符合
twx	签约
twy	稚
txa	繁荣
txb	每隔
txc	 
txd	第三
txe	胤
txf	第二
txg	篆
txh	第
txi	系
txj	每日
txk	片纸只字
txl	第四
txm	每周
txn	牝
txo	系数
txp	每家
txq	繁多
txr	系统的
txs	等级森严
txt	繁
txu	每
txv	第九
txw	每个
txx	筚
txy	牳
tya	入世
tyb	签订了
tyc	种族骚乱
tyd	各方面
tye	入股
tyf	䇾
tyg	往
tyh	往上
tyi	入
tyj	往日
tyk	稿
tyl	知识界
tym	篇幅
tyn	篇
tyo	籴
typ	知识密集
tyq	往外
tyr	篱
tys	笔记本
tyt	彷
tyu	知识产权
tyv	稂
tyw	知识分子
tyx	知识经济
tyy	入市
uaa	新工艺
uab	总医院
uac	并能
uad	疘
uae	并且
uaf	疳
uag	瓶
uah	并非
uai	冻
uaj	并
uak	阈
ual	并转
uam	癀
uan	并以
uao	总营业额
uap	迸
uaq	艵
uar	并提
uas	并要
uat	并行
uau	亲切问候
uav	剏
uaw	瘩
uax	新世纪
uay	䇅
uba	普及工作
ubb	 
ubc	 
ubd	闻
ube	疓
ubf	逆境
ubg	普及型
ubh	竞聘上岗
ubi	疗法
ubj	兯
ubk	疗
ubl	逆转
ubm	㽾
ubn	塑性
ubo	塑料
ubp	美联社
ubq	瘾
ubr	 
ubs	痾
ubt	塑
ubu	凝聚着
ubv	部队建设
ubw	新阶段
ubx	 
uby	疗效
uca	痉
ucb	新台阶
ucc	瘮
ucd	普通百姓
uce	痛
ucf	并通过
ucg	冯
uch	 
uci	新能源
ucj	 
uck	冶
ucl	 
ucm	 
ucn	痛心
uco	冶炼
ucp	 
ucq	痛饮
ucr	痛失
ucs	痛楚
uct	新台币
ucu	瘫痪
ucv	疤
ucw	瘫
ucx	 
ucy	瘙
uda	关节
udb	卷
udc	闳
udd	闫
ude	疬
udf	兰
udg	减
udh	眷
udi	头
udj	阉
udk	头号
udl	减轻
udm	头骨
udn	疣
udo	卷烟
udp	送
udq	鲞
udr	拳
uds	桊
udt	关系
udu	关
udv	券
udw	凑
udx	辫
udy	状
uea	前期
ueb	前卫
uec	前台
ued	閰
uee	毅力
uef	新加坡
ueg	疽
ueh	瘦
uei	前沿
uej	前
uek	瘸
uel	剪辑
uem	瘦肉
uen	前导
ueo	剪断
uep	遂
ueq	阋
uer	前提
ues	 
uet	前往
ueu	豙
uev	亲朋好友
uew	毅
uex	前线
uey	前方
ufa	闭幕
ufb	总支出
ufc	阖
ufd	㽵
ufe	尊老爱幼
uff	闺
ufg	壮
ufh	癫
ufi	疛
ufj	辛
ufk	斗
ufl	装置
ufm	装帧
ufn	闱
ufo	养料
ufp	闭塞
ufq	羌
ufr	前进的
ufs	装配
uft	闭
ufu	癫痫
ufv	闺女
ufw	养
ufx	总教练
ufy	装
uga	差
ugb	羞耻
ugc	羟
ugd	闰
uge	靖
ugf	
ugg	病毒
ugh	症
ugi	美洲
ugj	羊
ugk	半
ugl	盖
ugm	病
ugn	羞
ugo	羹
ugp	美容
ugq	冽
ugr	叛
ugs	美术
ugt	羲
ugu	善
ugv	姜
ugw	羚
ugx	冱
ugy	癍
uha	疲劳
uhb	半辈子
uhc	疲
uhd	㾇
uhe	 
uhf	冰上运动
uhg	着眼于
uhh	癯
uhi	 
uhj	并非是
uhk	丫
uhl	疲软
uhm	站岗
uhn	前瞻性
uho	 
uhp	 
uhq	差点儿
uhr	前些年
uhs	总目标
uht	站长
uhu	站立
uhv	并非如此
uhw	疲倦
uhx	疵
uhy	冷眼旁观
uia	资源共享
uib	减少了
uic	 
uid	并没有
uie	痟
uif	冰雪
uig	新水平
uih	 
uii	閖
uij	 
uik	冰川
uil	美洲国家
uim	冰山
uin	冰层
uio	冰糖
uip	立党之本
uiq	奖学金
uir	阔气
uis	立法机关
uit	阔
uiu	新兴产业
uiv	 
uiw	瘠
uix	 
uiy	冰
uja	新时期
ujb	间隔
ujc	 
ujd	间
uje	竭力
ujf	音
ujg	疸
ujh	音频
uji	闽
ujj	阊
ujk	音响
ujl	瘟
ujm	意见
ujn	意
ujo	间断
ujp	病虫害
ujq	竟
ujr	间接
ujs	赣榆
ujt	音乐
uju	童装
ujv	韶
ujw	音像
ujx	戠
ujy	意识
uka	问世
ukb	部
ukc	总参
ukd	问
uke	况且
ukf	咅
ukg	瓿
ukh	冲
uki	冲洗
ukj	剖
ukk	癌
ukl	部署
ukm	总则
ukn	总
uko	总数
ukp	冲突
ukq	况
ukr	产品质量
uks	竞相
ukt	部长
uku	部门
ukv	问好
ukw	部分
ukx	总统
uky	总计
ula	单项
ulb	郸
ulc	 
uld	痼
ule	单用
ulf	单元
ulg	兽
ulh	 
uli	瘝
ulj	单
ulk	闸
ull	美国国会
ulm	 
uln	冁
ulo	美国康柏电脑公司
ulp	单字
ulq	单独
ulr	单据
uls	阃
ult	单向
ulu	美国总统
ulv	瘻
ulw	单位
ulx	瘰
uly	单词
uma	痶
umb	 
umc	 
umd	端
ume	半山腰
umf	凋
umg	端正
umh	端点
umi	弊
umj	 
umk	疝
uml	 
umm	瘿
umn	并网发电
umo	端庄
ump	 
umq	 
umr	 
ums	 
umt	意见和建议
umu	弊端
umv	 
umw	端倪
umx	 
umy	端详
una	癜
unb	阚
unc	闷骚
und	决不
une	决胜
unf	问心无愧
ung	翊
unh	瘕
uni	闷
unj	 
unk	癖
unl	关心国家大事
unm	 
unn	䇃
uno	决断
unp	决定
unq	闲情逸致
unr	疡
uns	 
unt	决策
unu	新情况
unv	㽶
unw	决
unx	痆
uny	决议
uoa	产业革命
uob	普及
uoc	普通
uod	卷烟厂
uoe	判断力
uof	北煤南运
uog	普
uoh	 
uoi	焛
uoj	资料显示
uok	 
uol	产业界
uom	 
uon	 
uoo	痰
uop	意料之中
uoq	 
uor	首席执行官
uos	普查
uot	 
uou	产业部门
uov	瘘
uow	产业化
uox	产业结构
uoy	普遍
upa	 
upb	奠定了
upc	 
upd	竤
upe	并案办理
upf	亲密无间
upg	 
uph	痯
upi	竞赛活动
upj	凕
upk	半空中
upl	决定因素
upm	 
upn	兼容性
upo	养家糊口
upp	盗窃案
upq	盗窃犯
upr	冷空气
ups	兼容机
upt	音容笑貌
upu	问寒问暖
upv	 
upw	新社会
upx	遵守纪律
upy	 
uqa	阍
uqb	冲锋陷阵
uqc	竞争对手
uqd	奖
uqe	阎
uqf	将
uqg	癣
uqh	竞争上岗
uqi	浆
uqj	阄
uqk	奖品
uql	奖罚
uqm	痪
uqn	疱
uqo	资料
uqp	将军
uqq	资金
uqr	(
uqs	酱
uqt	§
uqu	资产
uqv	净
uqw	资
uqx	 
uqy	瘤
ura	新的贡献
urb	 
urc	㽹
urd	新的历史时期
ure	拳打脚踢
urf	前所未有
urg	前提下
urh	㾷
uri	新的水平
urj	新的里程碑
urk	䦐
url	 
urm	痸
urn	逆反心理
uro	 
urp	 
urq	新气象
urr	总指挥
urs	新技术
urt	辩护律师
uru	总投资
urv	新年好
urw	总揽全局
urx	 
ury	新的高度
usa	新区
usb	阐述了
usc	站柜台
usd	閪
use	新办
usf	瘭
usg	尊
ush	㓅
usi	闲
usj	亲临
usk	疔
usl	闲置
usm	尊崇
usn	亲属
uso	新材料
usp	遵守
usq	鹇
usr	新
uss	新村
ust	亲自
usu	亲
usv	新建
usw	凇
usx	新疆
usy	资本主义
uta	准备工作
utb	产生了
utc	产能
utd	疾
ute	产
utf	冼
utg	道理
uth	首
uti	新生活
utj	痢
utk	阁
utl	首轮
utm	立竿见影
utn	疙
uto	产业
utp	首家
utq	颜色
utr	首批
uts	产权
utt	产生
utu	疼
utv	痿
utw	产值
utx	部长级
uty	新知识
uua	立项
uub	阙
uuc	普普通通
uud	閚
uue	新闻办公室
uuf	立场
uug	痒
uuh	 
uui	立法
uuj	瘴
uuk	阅
uul	阐
uum	 
uun	新闻发布会
uuo	新闻广播
uup	立案
uuq	资产负债率
uur	新闻报道
uus	痫
uut	阐释
uuu	立
uuv	立即
uuw	立体
uux	前总统
uuy	阅读
uva	兼营
uvb	兼职
uvc	 
uvd	兼顾
uve	痕
uvf	妾
uvg	妆
uvh	 
uvi	䇐
uvj	 
uvk	㾒
uvl	 
uvm	 
uvn	歉收
uvo	歉
uvp	兼容
uvq	 
uvr	美好的
uvs	 
uvt	兼备
uvu	兼并
uvv	 
uvw	兼任
uvx	 
uvy	痕迹
uwa	阀
uwb	疮
uwc	疫
uwd	准确
uwe	疹
uwf	瘵
uwg	痊
uwh	冷战
uwi	闪
uwj	疥
uwk	总人口
uwl	益
uwm	准则
uwn	竌
uwo	闪烁
uwp	新华社
uwq	疯狂
uwr	疯
uws	部颁标准
uwt	准备
uwu	冷冻
uwv	竕
uww	痤
uwx	总供给
uwy	冷
uxa	北欧
uxb	邶
uxc	新经验
uxd	北大
uxe	背
uxf	递增
uxg	总经理
uxh	弟
uxi	北海
uxj	背景
uxk	冀中
uxl	冀
uxm	北山
uxn	北
uxo	闯红灯
uxp	遵纪守法
uxq	背负
uxr	背后
uxs	北极
uxt	凝
uxu	北部
uxv	疕
uxw	北风
uxx	兹
uxy	北京
uya	决议草案
uyb	门卫
uyc	㓍
uyd	訚
uye	閍
uyf	北京地区
uyg	冫
uyh	门
uyi	闵
uyj	咨询电话
uyk	凉
uyl	凛
uym	闹
uyn	阂
uyo	立方米
uyp	门窗
uyq	门外
uyr	善良的
uys	ā
uyt	丷
uyu	普遍关注
uyv	阆
uyw	瘁
uyx	痃
uyy	北京市
vaa	嫟
vab	媶
vac	 
vad	娀
vae	 
vaf	媒
vag	妅
vah	姬
vai	 
vaj	嫫
vak	嫤
val	媌
vam	媾
van	姖
vao	 
vap	如期实现
vaq	群芳争妍
var	妪
vas	 
vat	娆
vau	建功立业
vav	杂七杂八
vaw	媒体
vax	 
vay	㚤
vba	 
vbb	女孩子
vbc	好戏
vbd	好在
vbe	好办
vbf	㜽
vbg	好
vbh	邚
vbi	好学
vbj	 
vbk	好吃
vbl	好转
vbm	 
vbn	她
vbo	奶粉
vbp	好客
vbq	好多
vbr	好的
vbs	婀
vbt	奶
vbu	女子单打
vbv	奶奶
vbw	她们
vbx	好比
vby	好评
vca	既
vcb	即
vcc	驽
vcd	既有
vce	努
vcf	 
vcg	妈
vch	 
vci	即兴
vcj	既是
vck	始
vcl	好戏连台
vcm	帑
vcn	怒
vco	即席
vcp	既定
vcq	既然
vcr	怒气
vcs	即可
vct	奴役
vcu	厹
vcv	妈妈
vcw	即使
vcx	弩
vcy	奴
vda	媠
vdb	 
vdc	妭
vdd	 
vde	姑且
vdf	娠
vdg	姑
vdh	妚
vdi	九三学社
vdj	㛪
vdk	 
vdl	 
vdm	媆
vdn	如愿以偿
vdo	刀耕火种
vdp	好不容易
vdq	忍辱负重
vdr	建成投产
vds	妙不可言
vdt	姑息
vdu	㚑
vdv	姑娘
vdw	忍不住
vdx	 
vdy	 
vea	垦区
veb	退出
vec	 
ved	努力奋斗
vee	嫍
vef	垦
veg	姐
veh	嫂
vei	艮
vej	 
vek	退路
vel	退回
vem	退赔
ven	恳
veo	 
vep	退
veq	退色
ver	努力提高
ves	退票
vet	退税
veu	忍受着
vev	姐妹
vew	退休
vex	退缩
vey	努力方向
vfa	九十七
vfb	妹子
vfc	妓
vfd	九十三
vfe	寻觅
vff	娃
vfg	寻求
vfh	奸
vfi	妹
vfj	卆
vfk	嬉
vfl	九十四
vfm	婻
vfn	娡
vfo	 
vfp	杂志社
vfq	妩
vfr	寻找
vfs	孀
vft	姥
vfu	寻
vfv	娃娃
vfw	九十八
vfx	如雷贯耳
vfy	寻访
vga	妍
vgb	召开了
vgc	 
vgd	建成
vge	婊
vgf	建起
vgg	建平
vgh	嫣
vgi	嫩江
vgj	建昌
vgk	聿
vgl	建国
vgm	建账
vgn	 
vgo	娅
vgp	建
vgq	好事多磨
vgr	召开的
vgs	建材
vgt	建筑
vgu	建立
vgv	婕
vgw	好一个
vgx	姨
vgy	建设
vha	婋
vhb	 
vhc	 
vhd	如此而已
vhe	 
vhf	 
vhg	婌
vhh	㜹
vhi	如虎添翼
vhj	婥
vhk	肀
vhl	 
vhm	媜
vhn	㚶
vho	 
vhp	 
vhq	娊
vhr	如上所述
vhs	 
vht	如此等等
vhu	 
vhv	姹紫嫣红
vhw	如此众多的
vhx	 
vhy	如此说来
via	剥落
vib	录取
vic	 
vid	剥夺
vie	录用
vif	 
vig	姯
vih	剥皮
vii	隶
vij	肃
vik	女演员
vil	盝
vim	 
vin	灵活性
vio	如法炮制
vip	逮
viq	灵活多样
vir	逮捕
vis	灵活机动
vit	妙
viu	录
viv	媣
viw	录像
vix	灵活经营
viy	剥离
vja	 
vjb	好日子
vjc	 
vjd	旭
vje	 
vjf	旮
vjg	妲
vjh	妽
vji	如果没有
vjj	娼
vjk	录影唱片
vjl	媪
vjm	媀
vjn	 
vjo	 
vjp	 
vjq	㛫
vjr	 
vjs	巢
vjt	 
vju	 
vjv	嫉贤妒能
vjw	 
vjx	婫
vjy	如果说
vka	如期
vkb	邵
vkc	邕
vkd	如愿
vke	娟
vkf	召
vkg	如
vkh	如此
vki	如常
vkj	如果
vkk	召唤
vkl	召回
vkm	娲
vkn	恕
vko	如数
vkp	迢
vkq	欩
vkr	挐
vks	寻呼机
vkt	娱乐
vku	如意
vkv	 
vkw	如何
vkx	絮
vky	絮语
vla	巡回医疗
vlb	䣎
vlc	 
vld	姻
vle	娚
vlf	甾
vlg	㚼
vlh	嬽
vli	巡回演出
vlj	㓯
vlk	 
vll	 
vlm	㜥
vln	建国以来
vlo	 
vlp	㜕
vlq	㜛
vlr	邋
vls	 
vlt	 
vlu	 
vlv	㜢
vlw	鶅
vlx	嫘
vly	 
vma	婰
vmb	 
vmc	 
vmd	姎
vme	 
vmf	女同志
vmg	妯
vmh	奾
vmi	女同学
vmj	㞪
vmk	 
vml	 
vmm	姗
vmn	 
vmo	刀山火海
vmp	 
vmq	 
vmr	 
vms	 
vmt	 
vmu	 
vmv	灵丹妙药
vmw	妠
vmx	 
vmy	㛝
vna	㜊
vnb	㐇
vnc	 
vnd	好收成
vne	 
vnf	退居二线
vng	娜
vnh	婿
vni	孎
vnj	 
vnk	刀口
vnl	 
vnm	 
vnn	妃
vno	 
vnp	 
vnq	 
vnr	群情振奋
vns	刀枪
vnt	刀
vnu	㣽
vnv	刀刃
vnw	九届全国人大
vnx	妮
vny	姒
voa	灵巧
vob	 
voc	灵通
vod	灵感
voe	 
vof	灵魂
vog	 
voh	 
voi	灵活
voj	粛
vok	怒火中烧
vol	 
vom	灵山
von	㜙
voo	婒
vop	灵宝
voq	嫾
vor	妖魔鬼怪
vos	嬷
vot	㚧
vou	灵
vov	如火如荼
vow	灵便
vox	彞
voy	 
vpa	巡警
vpb	 
vpc	 
vpd	 
vpe	辺
vpf	婃
vpg	嫁
vph	婠
vpi	九寨沟
vpj	婶
vpk	 
vpl	巡回
vpm	帚
vpn	巡展
vpo	㛮
vpp	巡视
vpq	婉
vpr	嫔
vps	巡查
vpt	姹
vpu	嫁妆
vpv	巡
vpw	嫆
vpx	嫁给
vpy	巡诊
vqa	婚
vqb	媰
vqc	 
vqd	姽
vqe	 
vqf	肃然起敬
vqg	婚事
vqh	 
vqi	姚
vqj	姰
vqk	娩
vql	 
vqm	媍
vqn	㚿
vqo	婅
vqp	婚礼
vqq	姼
vqr	婚后
vqs	 
vqt	如鱼得水
vqu	夛
vqv	婚姻
vqw	如饥似渴
vqx	 
vqy	鸠
vra	 
vrb	 
vrc	㛂
vrd	㛓
vre	 
vrf	 
vrg	忍气吞声
vrh	妡
vri	姝
vrj	 
vrk	 
vrl	妙手回春
vrm	婂
vrn	 
vro	 
vrp	 
vrq	媿
vrr	㜱
vrs	 
vrt	婢
vru	怒气冲冲
vrv	 
vrw	妷
vrx	㜰
vry	好的方向
vsa	杂草
vsb	好极了
vsc	 
vsd	 
vse	 
vsf	嫖
vsg	㛉
vsh	奵
vsi	 
vsj	㜁
vsk	妸
vsl	 
vsm	 
vsn	 
vso	杂粮
vsp	如梦初醒
vsq	好样儿的
vsr	杂技
vss	㛦
vst	杂物
vsu	杂
vsv	如醉如痴
vsw	杂货
vsx	杂费
vsy	杂交
vta	群落
vtb	君子
vtc	 
vtd	娇
vte	尹
vtf	妊
vtg	姓
vth	媳
vti	九江
vtj	建筑师
vtk	群
vtl	媲
vtm	群山
vtn	九
vto	建筑业
vtp	姂
vtq	姓名
vtr	娥
vts	建筑材料
vtt	建筑物
vtu	媲美
vtv	媳妇
vtw	群众
vtx	建筑结构
vty	姀
vua	姘
vub	建立了
vuc	 
vud	录音磁带
vue	媊
vuf	㛙
vug	即将到来
vuh	 
vui	 
vuj	嫜
vuk	娧
vul	婵
vum	 
vun	 
vuo	 
vup	忍痛割爱
vuq	 
vur	如前所述
vus	娴
vut	嫉
vuu	好新闻
vuv	嫌
vuw	建立健全
vux	娣
vuy	娴熟
vva	女工
vvb	女子
vvc	 
vvd	女友
vve	 
vvf	㚣
vvg	妇
vvh	嬧
vvi	婚姻法
vvj	 
vvk	妱
vvl	 
vvm	女婴
vvn	女性
vvo	 
vvp	女神
vvq	女儿
vvr	女排
vvs	 
vvt	女篮
vvu	女单
vvv	女
vvw	女人
vvx	妇幼
vvy	女方
vwa	群众基础
vwb	 
vwc	群众观点
vwd	 
vwe	 
vwf	退休干部
vwg	录像带
vwh	 
vwi	刅
vwj	即使是
vwk	群众路线
vwl	群众团体
vwm	 
vwn	群众性
vwo	 
vwp	退伍军人
vwq	退休金
vwr	群众反映
vws	录像机
vwt	如何处理
vwu	群众意见
vwv	好人好事
vww	好几个
vwx	群众组织
vwy	妗
vxa	 
vxb	 
vxc	始终能够
vxd	始终不渝地
vxe	 
vxf	 
vxg	始终一贯
vxh	 
vxi	 
vxj	始终坚持
vxk	 
vxl	 
vxm	 
vxn	始终恪守
vxo	 
vxp	 
vxq	嫌疑犯
vxr	嬵
vxs	 
vxt	始终处于
vxu	嫋
vxv	始终如一
vxw	始终保持
vxx	妣
vxy	姆
vya	建设项目
vyb	 
vyc	好高骛远
vyd	訄
vye	忍受
vyf	建设者
vyg	娮
vyh	 
vyi	刃
vyj	 
vyk	婷
vyl	嬗
vym	建设周期
vyn	忍
vyo	 
vyp	娘家
vyq	建设银行
vyr	 
vys	 
vyt	妨
vyu	嫡
vyv	娘
vyw	姣
vyx	妶
vyy	妏
waa	代劳
wab	袋子
wac	今昔对比
wad	偌
wae	借助
waf	仝
wag	仜
wah	伢
wai	供水
waj	借
wak	代号
wal	全世界
wam	代购
wan	借以
wao	供应
wap	储蓄额
waq	儆
war	伛
was	伐木
wat	侥
wau	伊斯兰
wav	 
waw	供
wax	供给
way	伐
wba	戗
wbb	仓
wbc	 
wbd	仍有
wbe	创办
wbf	创刊
wbg	仔
wbh	䢳
wbi	创汇
wbj	创
wbk	 
wbl	他国
wbm	创见
wbn	他
wbo	创业
wbp	保卫祖国
wbq	仍然
wbr	风险投资
wbs	保险柜
wbt	仍
wbu	创新
wbv	创建
wbw	他们
wbx	仔细
wby	他说
wca	公共
wcb	仅限
wcc	公允
wcd	颂
wce	俑
wcf	公款
wcg	瓮
wch	您对此
wci	凤
wcj	公里
wck	公路
wcl	公园
wcm	凤山
wcn	翁
wco	公粮
wcp	公安
wcq	公然
wcr	公斤
wcs	俊杰
wct	俟
wcu	公
wcv	 
wcw	俊
wcx	公顷
wcy	仅
wda	佐
wdb	做出
wdc	伖
wdd	做成
wde	侑
wdf	侉
wdg	估
wdh	优点
wdi	做法
wdj	俺
wdk	佑
wdl	 
wdm	八达岭
wdn	优
wdo	供不应求
wdp	颁布实施
wdq	做饭
wdr	优势
wds	倚
wdt	做
wdu	僚
wdv	做好
wdw	段
wdx	全面贯彻
wdy	伏
wea	体力劳动
web	俘
wec	倍受欢迎
wed	使用寿命
wee	倗
wef	䏌
weg	仴
weh	佣
wei	优胜劣汰
wej	公用电话
wek	伽
wel	 
wem	偁
wen	全力以赴
weo	 
wep	信用社
weq	倪
wer	㐱
wes	使用权
wet	仂
weu	倍受尊敬
wev	俀
wew	使用价值
wex	使用费
wey	使用方法
wfa	偾
wfb	促进了
wfc	会
wfd	儒
wfe	舒服
wff	佳
wfg	仁
wfh	什
wfi	祭
wfj	仐
wfk	舍
wfl	传输
wfm	会见
wfn	传
wfo	伟业
wfp	领土完整
wfq	传销
wfr	传播
wfs	传真机
wft	佬
wfu	传送
wfv	佞
wfw	促进作用
wfx	传统
wfy	付
wga	使其
wgb	体现了
wgc	倒
wgd	癸
wge	傅
wgf	全
wgg	伍
wgh	今天上午
wgi	剑
wgj	便
wgk	合
wgl	僵
wgm	俩
wgn	兮
wgo	俨
wgp	使之
wgq	例
wgr	全年
wgs	余
wgt	使得
wgu	侠
wgv	例如
wgw	合作
wgx	全线
wgy	全市
wha	今非昔比
whb	个子
whc	佊
whd	凪
whe	 
whf	企
whg	佧
whh	企盼
whi	修水
whj	个
whk	个别
whl	企图
whm	侦
whn	候
who	企业
whp	侦察
whq	悠久
whr	悠扬
whs	侦查
wht	修
whu	修养
whv	修建
whw	俱
whx	修缮
why	仆
wia	倘若
wib	依法取缔
wic	化学能
wid	偿还
wie	俏
wif	化学武器
wig	低水平
wih	人海战术
wii	依法治国
wij	含水量
wik	 
wil	贪污罪
wim	倘
win	合法性
wio	合法席位
wip	偿
wiq	 
wir	化学反应
wis	合法权益
wit	依法行政
wiu	氽
wiv	依法逮捕
wiw	愈演愈烈
wix	合法经营
wiy	仦
wja	风景区
wjb	伸出
wjc	㑠
wjd	但愿
wje	 
wjf	俚
wjg	但
wjh	伸
wji	假日消费
wjj	介
wjk	㖋
wjl	僈
wjm	偶
wjn	倡导
wjo	偶数
wjp	 
wjq	偈
wjr	介质
wjs	倮
wjt	介入
wju	介意
wjv	 
wjw	假冒伪劣
wjx	介绍
wjy	倡议
wka	食品工业
wkb	保障
wkc	堡垒
wkd	保存
wke	集中力量
wkf	㕣
wkg	㐰
wkh	促
wki	保温
wkj	分别是
wkk	侣
wkl	合唱团
wkm	从中央到地方
wkn	个别情况
wko	集中精力
wkp	保密
wkq	保留
wkr	保护
wks	保
wkt	保管
wku	保养
wkv	公路建设
wkw	保健
wkx	分别比
wky	保证
wla	俄罗斯
wlb	 
wlc	人困马乏
wld	欲罢不能
wle	贫困县
wlf	贫困地区
wlg	佃
wlh	伡
wli	 
wlj	 
wlk	 
wll	儡
wlm	 
wln	全国性
wlo	集思广益
wlp	集团军
wlq	㑩
wlr	传输控制协议
wls	 
wlt	全国各地
wlu	全国总工会
wlv	全国妇联
wlw	集团公司
wlx	全国纪录
wly	贫困户
wma	＠
wmb	№
wmc	坐山观虎斗
wmd	⒈
wme	催办
wmf	倜
wmg	侗
wmh	仙
wmi	仙游
wmj	侧
wmk	「
wml	〇
wmm	 
wmn	合同书
wmo	 
wmp	他山之石
wmq	⒎
wmr	合同制
wms	◇
wmt	侧重
wmu	 
wmv	仙女
wmw	催
wmx	 
wmy	○
wna	假药
wnb	倔
wnc	侯马
wnd	倨
wne	追加
wnf	亿元
wng	伺
wnh	假
wni	领导小组
wnj	人民日报
wnk	僻
wnl	追回
wnm	领导同志
wnn	亿
wno	阜康
wnp	追究
wnq	人民银行
wnr	人民的
wns	人民检察院
wnt	侯
wnu	偋
wnv	亾
wnw	领导人
wnx	伲
wny	似
woa	含糊其词
wob	企业承包
woc	 
wod	健康成长
woe	 
wof	创业者
wog	停业整顿
woh	俯瞰
woi	㶡
woj	供应量
wok	企业员工
wol	企业界
wom	伙同
won	健康发展
woo	倓
wop	企业家
woq	僯
wor	人类的
wos	 
wot	企业管理
wou	健康状况
wov	偻
wow	俯
wox	分数线
woy	伙
wpa	贫穷落后
wpb	从实际出发
wpc	保密观念
wpd	公安厅
wpe	侬
wpf	公安干警
wpg	伫
wph	倌
wpi	保守党
wpj	 
wpk	侦察员
wpl	保守思想
wpm	八宝山
wpn	公安局
wpo	 
wpp	会客室
wpq	倇
wpr	傧
wps	公安机关
wpt	候补委员
wpu	公安部
wpv	侒
wpw	倥
wpx	佗
wpy	保定市
wqa	低
wqb	仰
wqc	低能
wqd	儋
wqe	 
wqf	釡
wqg	低于
wqh	低频
wqi	你
wqj	仍然是
wqk	像
wql	 
wqm	偩
wqn	低层
wqo	低廉
wqp	供销社
wqq	侈
wqr	偬
wqs	，
wqt	华尔街
wqu	低产
wqv	你好
wqw	你们
wqx	低级
wqy	㐴
wra	便携式
wrb	爷
wrc	爸
wrd	伊拉克
wre	飕
wrf	釜
wrg	伯
wrh	伒
wri	风
wrj	风景
wrk	风味
wrl	保护国
wrm	众所周知
wrn	体制改革
wro	飚
wrp	风寒
wrq	爹
wrr	斧
wrs	风格
wrt	俾
wru	父
wrv	传播媒体
wrw	佚
wrx	父母
wry	风扇
wsa	佳木斯
wsb	命根子
wsc	体验
wsd	何在
wse	体力
wsf	体坛
wsg	体
wsh	仃
wsi	凩
wsj	剁
wsk	何
wsl	人机界面
wsm	体内
wsn	何以
wso	僳
wsp	分析家
wsq	鸺
wsr	体制
wss	傈
wst	体系
wsu	朵
wsv	偠
wsw	体会
wsx	分配比例
wsy	休
wta	伥
wtb	作出
wtc	仫
wtd	侨
wte	伤
wtf	任
wtg	件
wth	作
wti	作法
wtj	俐
wtk	作品
wtl	傻
wtm	信息网络
wtn	几
wto	作业
wtp	作家
wtq	公积金
wtr	俄
wts	什么样
wtt	￥
wtu	佟
wtv	倭
wtw	任何
wtx	侮
wty	八
wua	全部工作
wub	伴随
wuc	领奖台
wud	倦
wue	倍受
wuf	伞
wug	位
wuh	 
wui	公关小姐
wuj	僮
wuk	倍
wul	僧
wum	全部财产
wun	们
wuo	创新精神
wup	 
wuq	公益金
wur	健美操
wus	坐冷板凳
wut	集装箱
wuu	仒
wuv	休闲娱乐
wuw	合资企业
wux	合资经营
wuy	分辨率
wva	分散
wvb	分子
wvc	众怒难犯
wvd	颁
wve	佷
wvf	坌
wvg	健
wvh	分歧
wvi	分流
wvj	分量
wvk	分别
wvl	盆
wvm	贫
wvn	仇
wvo	健康
wvp	侵
wvq	分钟
wvr	分
wvs	分析
wvt	伊
wvu	颁奖
wvv	伊始
wvw	健全
wvx	分组
wvy	仞
wwa	人工
wwb	耸
wwc	人参
wwd	从而
wwe	俎
wwf	坐
wwg	丛
wwh	从此
wwi	从小
wwj	价
wwk	谷
wwl	任何国家
wwm	个人财产
wwn	仉
wwo	人类
wwp	份额
wwq	众多
wwr	他们的
wws	价格
wwt	人生
wwu	仌
wwv	份
www	众
wwx	伦
wwy	从
wxa	化工
wxb	仑
wxc	化验
wxd	倾
wxe	化肥
wxf	华
wxg	僶
wxh	伄
wxi	化学
wxj	佛
wxk	华中
wxl	货车
wxm	货
wxn	化
wxo	华灯
wxp	华安
wxq	化解
wxr	几经反复
wxs	货柜
wxt	货币
wxu	华北
wxv	创纪录
wxw	华人
wxx	偕
wxy	㑄
wya	仪式
wyb	隽
wyc	令
wyd	А
wye	依
wyf	储
wyg	信
wyh	停止
wyi	凡
wyj	侪
wyk	停
wyl	集团
wym	集邮
wyn	今
wyo	焦
wyp	住家
wyq	依然
wyr	仪
wys	集
wyt	仿
wyu	傍
wyv	食
wyw	佼
wyx	集约
wyy	伩
xaa	练功
xab	经营承包
xac	 
xad	绒
xae	红肿
xaf	绀
xag	红
xah	弫
xai	经营活动
xaj	红星
xak	缂
xal	经营思想
xam	彉
xan	练
xao	红火
xap	红军
xaq	红色
xar	练兵
xas	经营机制
xat	绕
xau	经营单位
xav	红娘
xaw	经营企业
xax	毕恭毕敬
xay	红旗
xba	 
xbb	䌰
xbc	緅
xbd	 
xbe	 
xbf	♂
xbg	弭
xbh	鄳
xbi	 
xbj	 
xbk	级别
xbl	 
xbm	绌
xbn	弛
xbo	 
xbp	 
xbq	 
xbr	 
xbs	继承权
xbt	继承和发扬
xbu	级差
xbv	 
xbw	继承人
xbx	维也纳
xby	级
xca	经
xcb	 
xcc	缀
xcd	经历
xce	经受
xcf	经过
xcg	绎
xch	 
xci	经济
xcj	䥒
xck	绐
xcl	 
xcm	经典
xcn	弝
xco	绝对数
xcp	经验之谈
xcq	经贸
xcr	弘扬
xcs	 
xct	经委
xcu	疑难问题
xcv	疑难杂症
xcw	绝对优势
xcx	经费
xcy	弘
xda	 
xdb	经历了
xdc	绂
xdd	毋
xde	强有力
xdf	绔
xdg	缄
xdh	比不上
xdi	强硬派
xdj	弼
xdk	比历史最高水平
xdl	 
xdm	顷
xdn	缅怀
xdo	 
xdp	经研究决定
xdq	绝大多数
xdr	强大的
xds	绮
xdt	绑
xdu	缭
xdv	绝不姑息
xdw	绝不食言
xdx	缭绕
xdy	顷刻
xea	幼苗
xeb	孧
xec	 
xed	组成
xee	绷
xef	经受考验
xeg	组
xeh	缓步
xei	幼小
xej	幼虫
xek	组员
xel	组团
xem	 
xen	缓慢
xeo	 
xep	绶
xeq	缓解
xer	幼年
xes	䌽
xet	幼
xeu	组装
xev	绥
xew	组合
xex	组织
xey	 
xfa	 
xfb	引起了
xfc	纭
xfd	结成
xfe	 
xff	线索
xfg	疆
xfh	缜
xfi	结汇
xfj	结果
xfk	结
xfl	引起轰动
xfm	贯
xfn	续
xfo	结业
xfp	贯穿
xfq	鸨
xfr	编者按
xfs	结构
xft	绪
xfu	乡干部
xfv	结婚
xfw	绫
xfx	线
xfy	纣
xga	 
xgb	纯
xgc	编列预算
xgd	彑
xge	缚
xgf	弖
xgg	纯正
xgh	统一战线
xgi	纯洁
xgj	绠
xgk	统一口径
xgl	缰
xgm	绩
xgn	纯属
xgo	彝
xgp	统一祖国
xgq	维吾尔
xgr	统一的
xgs	统一标准
xgt	彘
xgu	纯净
xgv	緀
xgw	统一领导
xgx	统一组织
xgy	彝族
xha	纑
xhb	引出
xhc	紴
xhd	绯
xhe	引用
xhf	引进
xhg	䊼
xhh	引
xhi	缈
xhj	绰
xhk	引路
xhl	盄
xhm	緽
xhn	引导
xho	引爆
xhp	 
xhq	絸
xhr	比上年
xhs	引述
xht	引入
xhu	统战部
xhv	 
xhw	引人
xhx	引线
xhy	引言
xia	经济工作
xib	经济联系
xic	 
xid	颍
xie	绡
xif	经济增长
xig	经济形势
xih	经济上
xii	经济学
xij	经济日报
xik	经济中心
xil	经济界
xim	绱
xin	经济发展
xio	 
xip	经济实力
xiq	经济贸易
xir	经济损失
xis	经济林
xit	纱
xiu	糸
xiv	经济建设
xiw	经济合作
xix	经济结构
xiy	经济效益
xja	费工
xjb	繓
xjc	费劲
xjd	旨在
xje	费用
xjf	旨
xjg	缇
xjh	绅
xji	縨
xjj	费时
xjk	弗
xjl	缦
xjm	费
xjn	费尽
xjo	 
xjp	 
xjq	艴
xjr	 
xjs	綶
xjt	缆
xju	䭫
xjv	䭬
xjw	鴲
xjx	绲
xjy	 
xka	强项
xkb	缉
xkc	强劲
xkd	强大
xke	绢
xkf	强者
xkg	强烈
xkh	紃
xki	强渡
xkj	绳
xkk	缲
xkl	强国
xkm	縜
xkn	强悍
xko	强度
xkp	 
xkq	 
xkr	强制
xks	织机
xkt	强行
xku	强壮
xkv	强奸
xkw	织
xkx	强弱
xky	强调
xla	细菌
xlb	编辑出版
xlc	比较难
xld	比较丰富
xle	细胞
xlf	细雨
xlg	细
xlh	 
xli	细小
xlj	比较显著
xlk	比较顺利
xll	比较困难
xlm	细则
xln	缌
xlo	 
xlp	比较突出
xlq	比较多的
xlr	㢴
xls	细想
xlt	细微
xlu	编辑部
xlv	细嫩
xlw	细化
xlx	缧
xly	 
xma	经典著作
xmb	 
xmc	 
xmd	紻
xme	縎
xmf	绸
xmg	紬
xmh	㢫
xmi	 
xmj	 
xmk	絅
xml	 
xmm	缨
xmn	緺
xmo	纳米
xmp	 
xmq	㢷
xmr	纲
xms	纲要
xmt	纳入
xmu	纳闷
xmv	 
xmw	纳
xmx	统购统销
xmy	 
xna	缗
xnb	母子
xnc	比翼双飞
xnd	䋧
xne	绞尽脑汁
xnf	纪元
xng	弓
xnh	纠
xni	幻觉
xnj	幻影
xnk	䌟
xnl	 
xnm	 
xnn	纪
xno	幻灯
xnp	纪实
xnq	 
xnr	纽扣
xns	纪检
xnt	纪律
xnu	母亲
xnv	纪录
xnw	缪
xnx	纽约
xny	母语
xoa	彍
xob	继承
xoc	絋
xod	继而
xoe	 
xof	毕业考试
xog	毕业班
xoh	 
xoi	 
xoj	缠
xok	 
xol	毋庸置疑
xom	毕业典礼
xon	继
xoo	引火烧身
xop	 
xoq	繗
xor	纳米技术
xos	纳米材料
xot	纩
xou	 
xov	缕
xow	毕业分配
xox	粥
xoy	䋛
xpa	综艺
xpb	弥补了
xpc	综观
xpd	綋
xpe	 
xpf	综
xpg	绽
xph	绾
xpi	缩小
xpj	缩影
xpk	张家口
xpl	緷
xpm	 
xpn	绳之以法
xpo	 
xpp	缩写
xpq	紞
xpr	缤
xps	综述
xpt	缩短
xpu	缩减
xpv	 
xpw	缩
xpx	缤纷
xpy	缩放
xqa	纸
xqb	 
xqc	绝
xqd	绝不
xqe	繲
xqf	绝无
xqg	䋮
xqh	约占
xqi	弥
xqj	绚
xqk	绝唱
xql	幼儿园
xqm	约见
xqn	 
xqo	绚烂
xqp	弥补
xqq	弥留
xqr	绝招
xqs	绿色植物
xqt	纸币
xqu	经贸关系
xqv	绉
xqw	乡镇企业
xqx	纸张
xqy	约
xra	维护世界和平
xrb	绵阳
xrc	弧
xrd	维持原判
xre	 
xrf	红白喜事
xrg	絈
xrh	紤
xri	絑
xrj	 
xrk	 
xrl	经年累月
xrm	绵
xrn	强制性
xro	弧度
xrp	维护社会稳定
xrq	䌆
xrr	强制执行
xrs	 
xrt	绵延
xru	绵羊
xrv	强手如林
xrw	强迫命令
xrx	缴纳
xry	缴
xsa	 
xsb	 
xsc	纵横驰骋
xsd	㯋
xse	 
xsf	缥
xsg	絤
xsh	糽
xsi	 
xsj	 
xsk	彁
xsl	 
xsm	 
xsn	结构性
xso	统配煤矿总公司
xsp	 
xsq	纸醉金迷
xsr	缴械投降
xss	红楼梦
xst	 
xsu	维权意识
xsv	䌁
xsw	张榜公布
xsx	 
xsy	䊾
xta	张
xtb	绣
xtc	疑难
xtd	疑
xte	乡
xtf	纤
xtg	绗
xth	绺
xti	纯利润
xtj	比利时
xtk	络
xtl	张罗
xtm	张贴
xtn	匕
xto	䋺
xtp	贯彻实施
xtq	乡镇
xtr	贯彻执行
xts	绦
xtt	终身
xtu	终
xtv	緌
xtw	飨
xtx	纤维
xty	张望
xua	弹药
xub	縌
xuc	 
xud	绻
xue	弹力
xuf	弱者
xug	绊
xuh	弱点
xui	弱小
xuj	繶
xuk	綐
xul	弹
xum	㢼
xun	弹性
xuo	 
xup	弱视
xuq	絘
xur	 
xus	緧
xut	弹簧
xuu	弹头
xuv	缣
xuw	缢
xux	弱
xuy	终端设备
xva	绿茵
xvb	 
xvc	 
xvd	 
xve	绿肥
xvf	绿地
xvg	绿豆
xvh	绿卡
xvi	绿
xvj	缫
xvk	绍
xvl	缁
xvm	 
xvn	䊵
xvo	绿灯
xvp	弹丸之地
xvq	绿色
xvr	 
xvs	绿树
xvt	糿
xvu	 
xvv	 
xvw	绿化
xvx	 
xvy	纫
xwa	 
xwb	给出
xwc	给予
xwd	缎
xwe	维修服务
xwf	绘
xwg	给
xwh	引人瞩目
xwi	引人注目
xwj	纪念日
xwk	纷呈
xwl	绘图
xwm	红领巾
xwn	缑
xwo	综合业务
xwp	给定
xwq	纪念馆
xwr	维护
xws	纵横
xwt	综合利用
xwu	综合症
xwv	纷
xww	纵
xwx	纶
xwy	维
xxa	畿
xxb	纨绔子弟
xxc	继续通过
xxd	络绎不绝
xxe	继续加强
xxf	毕
xxg	丝
xxh	组织上
xxi	继续深化
xxj	绋
xxk	纺织品
xxl	比较
xxm	缘由
xxn	比
xxo	毕业
xxp	比赛
xxq	纺织印染
xxr	皆
xxs	组织机构
xxt	比重
xxu	毕竟
xxv	比如
xxw	比例
xxx	幺
xxy	丝毫
xya	编著
xyb	编队
xyc	统
xyd	＜
xye	袰
xyf	编者
xyg	统一
xyh	统战
xyi	统治
xyj	统帅
xyk	缟
xyl	编辑
xym	统购
xyn	编
xyo	统计数字
xyp	编写
xyq	编印
xyr	缡
xys	统配
xyt	纺
xyu	缔
xyv	 
xyw	绞
xyx	弦
xyy	纹
yaa	试
yab	施工队
yac	试验
yad	诺
yae	试用
yaf	谋
yag	讧
yah	讶
yai	文艺演出
yaj	谟
yak	谨
yal	试图
yam	计划内
yan	谍
yao	 
yap	文艺家
yaq	谮
yar	讴
yas	讴歌
yat	计划生育
yau	施工单位
yav	讳莫如深
yaw	诬
yax	计划经济
yay	谎
yba	 
ybb	谁也阻挡不了
ybc	诹
ybd	望子成龙
ybe	讔
ybf	斈
ybg	誀
ybh	邡
ybi	谁也没有想到
ybj	 
ybk	㓙
ybl	 
ybm	诎
ybn	訑
ybo	 
ybp	 
ybq	 
ybr	 
ybs	 
ybt	䚮
ybu	 
ybv	 
ybw	为了什么
ybx	 
yby	市盈率
yca	弃
ycb	充盈
ycc	主观能动性
ycd	译码
yce	育
ycf	交通运输
ycg	译
ych	育龄
yci	充满
ycj	充电
yck	诒
ycl	试验田
ycm	交通岗
ycn	谲
yco	高难度
ycp	充实
ycq	充
ycr	充斥
ycs	译本
yct	诶
ycu	交通部
ycv	 
ycw	充分
ycx	交通线
ycy	译文
yda	衣不蔽体
ydb	ā
ydc	夜不能寐
ydd	享有盛誉
yde	詴
ydf	望而却步
ydg	诂
ydh	谈不上
ydi	诔
ydj	高压电
ydk	变压器
ydl	 
ydm	斋
ydn	诚
ydo	诙
ydp	诚实
ydq	毫不犹豫
ydr	诚挚
yds	就不可能
ydt	放在第一位
ydu	放在首位
ydv	诚恳
ydw	遍布全国
ydx	高压线
ydy	诙谐
yea	试用期
yeb	 
yec	 
yed	施加压力
yee	彣
yef	主办者
yeg	诅
yeh	謏
yei	衣裳
yej	施加影响
yek	诅咒
yel	 
yem	裔
yen	 
yeo	 
yep	主力军
yeq	誽
yer	谣
yes	 
yet	䚲
yeu	衣
yev	 
yew	谀
yex	謑
yey	谣言
yfa	计划
yfb	讲了
yfc	讲台
yfd	讨厌
yfe	主动脉
yff	诗
yfg	市场环境
yfh	计
yfi	认真学习
yfj	讲
yfk	诘
yfl	计较
yfm	谳
yfn	读
yfo	讲座
yfp	读写
yfq	诸多
yfr	记者招待会
yfs	讲述
yft	诸
yfu	市场竞争
yfv	诸如
yfw	诗人
yfx	市场经济
yfy	讨
yga	这一切
ygb	评出
ygc	主观
ygd	主
yge	请
ygf	主动
ygg	请求
ygh	证
ygi	主流
ygj	㪯
ygk	语
ygl	谏
ygm	请帖
ygn	证书
ygo	主席
ygp	评审
ygq	语句
ygr	主持
ygs	主要
ygt	主管
ygu	评
ygv	市政建设
ygw	主任
ygx	主张
ygy	语言
yha	谑
yhb	这辈子
yhc	詖
yhd	诽
yhe	 
yhf	高瞻远瞩
yhg	让
yhh	让步
yhi	 
yhj	放虎归山
yhk	让路
yhl	弃旧图新
yhm	盲目崇拜
yhn	盲目性
yho	让座
yhp	䜜
yhq	谈虎色变
yhr	这些年
yhs	 
yht	让利
yhu	卞
yhv	盲目建设
yhw	让位
yhx	让给
yhy	讣
yia	文学艺术
yib	商学院
yic	高举邓小平理论伟大旗帜
yid	就没有
yie	诮
yif	高兴地
yig	高水平
yih	交汇点
yii	氷
yij	旅游景点
yik	交流中心
yil	文学界
yim	 
yin	旅游局
yio	旅游业
yip	谠
yiq	 
yir	高尚的
yis	讲清楚
yit	充满生机
yiu	旅游资源
yiv	 
yiw	充满信心
yix	交流经验
yiy	䚱
yja	计时工资
yjb	说明了
yjc	 
yjd	文明古国
yje	斔
yjf	斉
yjg	这是一次
yjh	刘
yji	课堂
yjj	齐
yjk	交易中心
yjl	谩
yjm	 
yjn	说明书
yjo	 
yjp	交易额
yjq	谒
yjr	这里的
yjs	课
yjt	课程
yju	蚉
yjv	 
yjw	齐全
yjx	文明经商
yjy	交易市场
yka	误区
ykb	郭
ykc	就能
ykd	高达
yke	哀
ykf	吝
ykg	误
ykh	训
yki	京
ykj	就是
ykk	襄
ykl	哀思
ykm	高
ykn	高层
yko	高度
ykp	亮
ykq	误解
ykr	高手
yks	就要
ykt	熟悉
yku	高产
ykv	衰退
ykw	识
ykx	高级
yky	高效
yla	市辖区
ylb	设置障碍
ylc	畆
yld	 
yle	谓
ylf	亩
ylg	訵
ylh	䛅
yli	褱
ylj	 
ylk	颤
yll	讄
ylm	 
yln	諰
ylo	 
ylp	謰
ylq	为国争光
ylr	颤抖
yls	 
ylt	交界处
ylu	亩产
ylv	謱
ylw	谡
ylx	 
yly	帝国主义
yma	调节
ymb	调出
ymc	 
ymd	调研
yme	调用
ymf	调
ymg	䛆
ymh	讪
ymi	 
ymj	市内电话
ymk	调味
yml	调回
ymm	市内
ymn	市民
ymo	调度
ymp	市容
ymq	调解
ymr	调控
yms	调查
ymt	市委
ymu	市立
ymv	 
ymw	讷
ymx	 
ymy	调试
yna	刻苦
ynb	㐎
ync	高性能
ynd	戾
yne	户
ynf	讯
yng	诩
ynh	盲
yni	永
ynj	永昌
ynk	启
ynl	妄图
ynm	遍
ynn	记
yno	永康
ynp	诀窍
ynq	永久
ynr	衷心的感谢
yns	记述
ynt	刻
ynu	忞
ynv	亡
ynw	雇
ynx	词组
yny	房
yoa	弈
yob	孪
yoc	变
yod	奕
yoe	恋爱
yof	变动
yog	谈到
yoh	䛸
yoi	高精尖
yoj	蛮
yok	计数器
yol	主席团
yom	峦
yon	恋
yoo	谈
yop	迹
yoq	銮
yor	挛
yos	栾
yot	变得
you	亦
yov	娈
yow	变化
yox	弯
yoy	詸
ypa	 
ypb	谱写了
ypc	主客观
ypd	说实在的
ype	谊
ypf	熟视无睹
ypg	这一
yph	这些
ypi	这
ypj	这是
ypk	读写器
ypl	诨
ypm	 
ypn	议定书
ypo	这类
ypp	衣衫褴褛
ypq	这儿
ypr	 
yps	这样
ypt	诧
ypu	这次
ypv	 
ypw	这个
ypx	詑
ypy	说实话
yqa	诋
yqb	䛄
yqc	 
yqd	诡
yqe	谄
yqf	肩负起
yqg	方针政策
yqh	 
yqi	课外活动
yqj	询
yqk	谗
yql	 
yqm	讂
yqn	永久性
yqo	諊
yqp	言外之意
yqq	袲
yqr	肩负的
yqs	 
yqt	诳
yqu	询问
yqv	诌
yqw	许多人
yqx	调解纠纷
yqy	这句话
yra	离散
yrb	离
yrc	䛀
yrd	离奇
yre	 
yrf	义卖
yrg	诟
yrh	
yri	义
yrj	高质量
yrk	离别
yrl	譕
yrm	旆
yrn	离心
yro	主持座谈会
yrp	离家
yrq	调制解调器
yrr	诚挚的
yrs	高技术
yrt	义务
yru	交换意见
yrv	亵
yrw	主持人
yrx	高年级
yry	诉
ysa	主要功能
ysb	论述了
ysc	主要矛盾
ysd	主要原因
yse	主要力量
ysf	高枕无忧
ysg	主要表现
ysh	订
ysi	商标注册
ysj	谭
ysk	诃
ysl	主要因素
ysm	主要内容
ysn	为核心的
yso	主要精力
ysp	 
ysq	主要负责人
ysr	这样的
yss	主要标志
yst	主要特点
ysu	订单
ysv	订婚
ysw	这样做
ysx	调查结果
ysy	许可证
yta	旗
ytb	施
ytc	诈骗
ytd	话
yte	旅
ytf	许
ytg	放开
yth	诞
yti	旅游
ytj	话题
ytk	计算中心
ytl	旋转
ytm	谢
ytn	旋
yto	畜牧业
ytp	旅客
ytq	许多
ytr	高科技
yts	计算机
ytt	族
ytu	主管部门
ytv	诿
ytw	为人
ytx	诲
yty	放
yua	访问期间
yub	谦逊
yuc	旁观
yud	商厦
yue	谫
yuf	商场
yug	详
yuh	商战
yui	说法
yuj	谙
yuk	说
yul	商界
yum	商
yun	详尽
yuo	谱
yup	帝
yuq	谘
yur	高新技术
yus	商标
yut	谚
yuu	齐头并进
yuv	谦
yuw	谥
yux	详细
yuy	说话
yva	良药
yvb	 
yvc	朗
yvd	记录在案
yve	良
yvf	诚恳地
yvg	良好形象
yvh	诸如此类
yvi	文娱活动
yvj	良师
yvk	诏
yvl	良田
yvm	 
yvn	訅
yvo	 
yvp	誛
yvq	良久
yvr	良好的
yvs	良机
yvt	良种
yvu	 
yvv	良好
yvw	离退休
yvx	 
yvy	朗诵
ywa	交警
ywb	亢
ywc	设
ywd	颃
ywe	诊
ywf	认真
ywg	谕
ywh	充分肯定
ywi	交流
ywj	效果
ywk	褒
ywl	设置
ywm	认同
ywn	讥
ywo	诊断
ywp	认定
ywq	交锋
ywr	交
yws	设想
ywt	夜
ywu	六
ywv	文化建设
yww	卒
ywx	论
ywy	认
yxa	高级工程师
yxb	高级职称
yxc	 
yxd	训练有素
yxe	詏
yxf	高级干部
yxg	譝
yxh	訠
yxi	率
yxj	诣
yxk	高级中学
yxl	畜
yxm	 
yxn	䚰
yxo	高强度
yxp	高级官员
yxq	 
yxr	详细报道
yxs	 
yxt	雍
yxu	玄
yxv	高级建筑师
yxw	率领
yxx	谐
yxy	孶
yya	方式
yyb	设计院
yyc	方能
yyd	方面
yye	文采
yyf	文献
yyg	文
yyh	文具
yyi	方法
yyj	文明
yyk	谅
yyl	丶
yym	文山
yyn	该
yyo	文库
yyp	方案
yyq	方针
yyr	议
yys	文档
yyt	访
yyu	谤
yyv	文娱
yyw	谇
yyx	议论纷纷
yyy	言
